0061_02_0040.mp4
0075_02_0055.mp4
0063_01_0189.mp4
0171_01_0005.mp4
0039_04_0005.mp4
0082_06_0015.mp4
0015_01_0160.mp4
0009_01_0001.mp4
0064_01_0154.mp4
0103_04_0002.mp4
0012_05_0006.mp4
0019_01_0085.mp4
0072_01_0094.mp4
0062_00_0003.mp4
0074_03_0004.mp4
0042_01_0008.mp4
0022_01_0048.mp4
0057_01_0006.mp4
0012_01_0026.mp4
0075_05_0004.mp4
0019_06_0045.mp4
0151_06_0009.mp4
0120_03_0027.mp4
0059_03_0030.mp4
0179_05_0005.mp4
0006_03_0008.mp4
0052_01_0161.mp4
0011_00_0045.mp4
0008_01_0022.mp4
0051_01_0077.mp4
0094_03_0004.mp4
0033_01_0002.mp4
0039_01_0056.mp4
0007_01_0113.mp4
0122_02_0025.mp4
0124_01_0028.mp4
0129_02_0016.mp4
0082_01_0041.mp4
0139_04_0002.mp4
0013_02_0010.mp4
0022_06_0012.mp4
0004_01_0089.mp4
0192_02_0013.mp4
0094_03_0020.mp4
0178_06_0007.mp4
0071_02_0016.mp4
0077_01_0002.mp4
0142_03_0033.mp4
0121_01_0010.mp4
0175_00_0011.mp4
0136_01_0028.mp4
0038_01_0049.mp4
0043_01_0018.mp4
0089_01_0030.mp4
0077_01_0019.mp4
0070_01_0146.mp4
0127_01_0010.mp4
0075_02_0064.mp4
0050_01_0010.mp4
0066_02_0003.mp4
0175_01_0016.mp4
0114_01_0013.mp4
0028_02_0033.mp4
0183_01_0003.mp4
0020_01_0104.mp4
0113_01_0004.mp4
0015_01_0120.mp4
0182_03_0001.mp4
0025_04_0015.mp4
0081_02_0038.mp4
0104_01_0017.mp4
0004_05_0015.mp4
0052_03_0031.mp4
0051_03_0003.mp4
0116_01_0014.mp4
0004_05_0005.mp4
0004_01_0174.mp4
0078_01_0099.mp4
0004_01_0001.mp4
0004_03_0074.mp4
0099_05_0001.mp4
0156_03_0012.mp4
0010_01_0041.mp4
0131_01_0004.mp4
0088_02_0027.mp4
0105_02_0006.mp4
0036_01_0041.mp4
0004_01_0079.mp4
0020_03_0030.mp4
0184_05_0013.mp4
0039_02_0040.mp4
0126_02_0008.mp4
0078_02_0001.mp4
0003_02_0140.mp4
0008_01_0087.mp4
0011_00_0044.mp4
0006_03_0033.mp4
0144_02_0025.mp4
0009_03_0008.mp4
0026_03_0006.mp4
0100_01_0004.mp4
0019_01_0086.mp4
0022_01_0282.mp4
0065_02_0017.mp4
0022_01_0252.mp4
0089_02_0042.mp4
0100_02_0034.mp4
0189_01_0001.mp4
0047_03_0088.mp4
0063_01_0087.mp4
0103_01_0071.mp4
0044_06_0023.mp4
0071_03_0024.mp4
0039_01_0066.mp4
0061_06_0002.mp4
0030_00_0004.mp4
0020_03_0065.mp4
0054_03_0020.mp4
0078_05_0004.mp4
0124_01_0016.mp4
0004_03_0091.mp4
0020_01_0005.mp4
0036_03_0013.mp4
0007_06_0021.mp4
0078_02_0044.mp4
0059_02_0012.mp4
0070_01_0072.mp4
0031_02_0025.mp4
0061_00_0011.mp4
0160_01_0005.mp4
0015_01_0187.mp4
0091_01_0043.mp4
0103_01_0002.mp4
0108_01_0010.mp4
0068_00_0012.mp4
0124_01_0005.mp4
0145_05_0017.mp4
0067_06_0008.mp4
0118_03_0016.mp4
0091_01_0049.mp4
0072_00_0002.mp4
0052_01_0234.mp4
0061_01_0052.mp4
0041_06_0005.mp4
0171_01_0008.mp4
0031_03_0018.mp4
0042_06_0012.mp4
0095_03_0008.mp4
0016_03_0062.mp4
0028_01_0002.mp4
0188_01_0004.mp4
0160_01_0012.mp4
0057_01_0129.mp4
0062_01_0030.mp4
0032_02_0013.mp4
0096_00_0002.mp4
0035_06_0027.mp4
0027_04_0015.mp4
0010_03_0084.mp4
0007_01_0015.mp4
0071_01_0055.mp4
0050_06_0006.mp4
0008_01_0165.mp4
0028_01_0020.mp4
0119_02_0006.mp4
0014_06_0001.mp4
0070_01_0085.mp4
0087_01_0021.mp4
0012_06_0023.mp4
0126_02_0011.mp4
0031_02_0033.mp4
0047_02_0106.mp4
0191_01_0005.mp4
0074_02_0024.mp4
0018_02_0003.mp4
0116_03_0003.mp4
0129_02_0013.mp4
0078_02_0008.mp4
0009_01_0125.mp4
0089_06_0003.mp4
0019_06_0053.mp4
0057_01_0063.mp4
0038_01_0032.mp4
0042_01_0023.mp4
0171_06_0009.mp4
0026_02_0046.mp4
0071_01_0033.mp4
0057_01_0034.mp4
0166_00_0008.mp4
0078_00_0013.mp4
0078_02_0127.mp4
0060_01_0115.mp4
0113_01_0005.mp4
0072_01_0003.mp4
0064_01_0101.mp4
0008_01_0037.mp4
0102_02_0021.mp4
0080_06_0002.mp4
0025_01_0023.mp4
0185_02_0003.mp4
0051_06_0010.mp4
0057_01_0056.mp4
0078_02_0031.mp4
0036_03_0007.mp4
0175_01_0021.mp4
0147_01_0015.mp4
0057_01_0090.mp4
0041_02_0001.mp4
0061_01_0015.mp4
0060_01_0117.mp4
0040_02_0025.mp4
0053_01_0016.mp4
0104_05_0005.mp4
0019_01_0090.mp4
0009_01_0085.mp4
0157_06_0009.mp4
0040_02_0029.mp4
0083_02_0009.mp4
0076_02_0069.mp4
0007_02_0025.mp4
0044_01_0015.mp4
0132_06_0001.mp4
0085_02_0048.mp4
0006_03_0029.mp4
0015_01_0262.mp4
0010_02_0152.mp4
0032_01_0008.mp4
0042_01_0014.mp4
0004_03_0071.mp4
0184_02_0022.mp4
0006_02_0174.mp4
0016_01_0091.mp4
0027_04_0033.mp4
0052_01_0015.mp4
0021_00_0001.mp4
0064_01_0164.mp4
0089_02_0034.mp4
0046_01_0006.mp4
0039_01_0053.mp4
0071_02_0018.mp4
0118_00_0006.mp4
0080_01_0095.mp4
0089_05_0003.mp4
0131_01_0012.mp4
0005_05_0003.mp4
0003_02_0017.mp4
0037_01_0018.mp4
0017_01_0063.mp4
0115_04_0004.mp4
0075_01_0036.mp4
0119_05_0004.mp4
0025_03_0024.mp4
0016_03_0099.mp4
0064_02_0015.mp4
0017_06_0001.mp4
0188_01_0002.mp4
0013_00_0004.mp4
0071_01_0012.mp4
0071_01_0063.mp4
0086_06_0002.mp4
0072_01_0045.mp4
0070_06_0003.mp4
0079_02_0017.mp4
0018_06_0027.mp4
0026_00_0009.mp4
0078_01_0018.mp4
0143_02_0021.mp4
0006_02_0157.mp4
0093_02_0001.mp4
0010_02_0205.mp4
0010_01_0038.mp4
0120_03_0066.mp4
0010_02_0034.mp4
0188_03_0023.mp4
0080_01_0084.mp4
0130_03_0005.mp4
0011_00_0008.mp4
0036_01_0011.mp4
0003_02_0003.mp4
0047_02_0091.mp4
0075_02_0023.mp4
0005_02_0036.mp4
0058_04_0008.mp4
0089_03_0053.mp4
0009_01_0126.mp4
0156_06_0002.mp4
0078_02_0102.mp4
0108_02_0014.mp4
0017_02_0008.mp4
0087_03_0083.mp4
0009_01_0060.mp4
0085_01_0089.mp4
0107_01_0023.mp4
0190_02_0009.mp4
0100_01_0030.mp4
0031_06_0025.mp4
0016_03_0034.mp4
0185_03_0008.mp4
0111_01_0006.mp4
0151_06_0002.mp4
0154_02_0021.mp4
0020_02_0001.mp4
0119_04_0006.mp4
0031_00_0003.mp4
0191_00_0003.mp4
0010_01_0072.mp4
0016_01_0064.mp4
0012_03_0009.mp4
0162_03_0013.mp4
0115_02_0015.mp4
0124_01_0011.mp4
0128_02_0021.mp4
0172_02_0013.mp4
0046_01_0005.mp4
0036_01_0029.mp4
0119_05_0008.mp4
0093_01_0016.mp4
0078_02_0117.mp4
0070_01_0168.mp4
0185_05_0003.mp4
0020_03_0089.mp4
0095_01_0060.mp4
0018_01_0002.mp4
0036_01_0056.mp4
0036_02_0057.mp4
0069_03_0004.mp4
0124_02_0016.mp4
0016_03_0063.mp4
0059_01_0072.mp4
0104_01_0030.mp4
0077_01_0004.mp4
0133_01_0010.mp4
0058_01_0054.mp4
0091_01_0022.mp4
0016_03_0089.mp4
0010_01_0081.mp4
0144_01_0012.mp4
0068_00_0008.mp4
0048_02_0088.mp4
0004_01_0165.mp4
0057_01_0093.mp4
0148_02_0027.mp4
0191_06_0008.mp4
0086_01_0005.mp4
0040_06_0009.mp4
0161_05_0002.mp4
0184_02_0005.mp4
0004_01_0011.mp4
0046_01_0025.mp4
0061_01_0121.mp4
0126_01_0012.mp4
0019_02_0014.mp4
0026_05_0021.mp4
0015_01_0076.mp4
0076_02_0013.mp4
0014_01_0023.mp4
0137_03_0022.mp4
0109_02_0013.mp4
0180_02_0027.mp4
0077_01_0005.mp4
0025_01_0038.mp4
0179_00_0011.mp4
0054_03_0003.mp4
0063_01_0077.mp4
0004_03_0022.mp4
0027_01_0038.mp4
0047_03_0083.mp4
0089_01_0025.mp4
0130_00_0007.mp4
0061_06_0030.mp4
0016_01_0087.mp4
0028_05_0005.mp4
0051_01_0140.mp4
0190_00_0002.mp4
0131_02_0003.mp4
