0078_01_0121.mp4
0175_05_0004.mp4
0043_06_0001.mp4
0020_00_0004.mp4
0081_02_0040.mp4
0070_06_0021.mp4
0067_03_0040.mp4
0054_02_0014.mp4
0009_01_0073.mp4
0061_01_0153.mp4
0008_01_0005.mp4
0006_02_0071.mp4
0057_01_0014.mp4
0022_01_0179.mp4
0085_01_0011.mp4
0015_01_0251.mp4
0186_06_0005.mp4
0082_01_0042.mp4
0014_02_0013.mp4
0166_06_0003.mp4
0052_05_0006.mp4
0040_05_0001.mp4
0010_02_0183.mp4
0157_05_0002.mp4
0006_06_0011.mp4
0120_03_0062.mp4
0099_06_0001.mp4
0060_01_0046.mp4
0071_05_0001.mp4
0118_03_0013.mp4
0061_03_0022.mp4
0013_00_0006.mp4
0075_02_0082.mp4
0063_01_0113.mp4
0188_02_0003.mp4
0092_03_0006.mp4
0011_01_0008.mp4
0020_06_0022.mp4
0078_01_0052.mp4
0019_06_0042.mp4
0004_03_0061.mp4
0088_04_0002.mp4
0114_00_0008.mp4
0015_01_0218.mp4
0084_01_0009.mp4
0015_01_0239.mp4
0062_00_0008.mp4
0143_02_0017.mp4
0104_01_0019.mp4
0166_03_0010.mp4
0006_06_0048.mp4
0102_02_0001.mp4
0020_03_0055.mp4
0073_01_0013.mp4
0072_01_0008.mp4
0187_01_0024.mp4
0060_01_0094.mp4
0007_02_0011.mp4
0078_01_0080.mp4
0040_02_0010.mp4
0072_01_0061.mp4
0137_01_0007.mp4
0041_05_0001.mp4
0027_04_0037.mp4
0061_01_0066.mp4
0088_01_0018.mp4
0071_01_0056.mp4
0121_03_0007.mp4
0126_03_0003.mp4
0062_01_0013.mp4
0064_01_0129.mp4
0097_02_0028.mp4
0120_00_0015.mp4
0085_03_0007.mp4
0020_01_0091.mp4
0100_01_0062.mp4
0139_05_0005.mp4
0142_03_0055.mp4
0055_01_0009.mp4
0052_01_0229.mp4
0003_01_0090.mp4
0050_01_0004.mp4
0106_03_0001.mp4
0063_01_0168.mp4
0078_02_0081.mp4
0193_06_0004.mp4
0010_02_0229.mp4
0018_06_0057.mp4
0106_03_0021.mp4
0147_02_0002.mp4
0028_01_0026.mp4
0072_01_0084.mp4
0019_06_0064.mp4
0126_02_0001.mp4
0088_03_0026.mp4
0043_02_0003.mp4
0093_02_0024.mp4
0096_06_0002.mp4
0078_02_0105.mp4
0051_01_0158.mp4
0106_05_0009.mp4
0054_01_0002.mp4
0103_01_0038.mp4
0020_06_0009.mp4
0016_03_0066.mp4
0089_02_0076.mp4
0016_01_0122.mp4
0187_03_0079.mp4
0015_00_0013.mp4
0078_00_0003.mp4
0126_06_0001.mp4
0004_03_0009.mp4
0126_01_0005.mp4
0059_01_0065.mp4
0021_02_0058.mp4
0041_05_0013.mp4
0152_02_0007.mp4
0006_02_0064.mp4
0016_03_0186.mp4
0097_03_0006.mp4
0082_06_0060.mp4
0052_05_0030.mp4
0017_01_0172.mp4
0124_02_0027.mp4
0050_00_0005.mp4
0182_02_0005.mp4
0008_01_0166.mp4
0084_03_0002.mp4
0162_02_0005.mp4
0103_01_0041.mp4
0161_02_0001.mp4
0068_06_0016.mp4
0110_02_0009.mp4
0027_04_0002.mp4
0009_01_0012.mp4
0078_02_0026.mp4
0089_03_0037.mp4
0121_01_0007.mp4
0003_01_0046.mp4
0109_01_0017.mp4
0076_03_0001.mp4
0016_03_0026.mp4
0061_01_0107.mp4
0047_02_0031.mp4
0059_03_0031.mp4
0014_01_0066.mp4
0088_01_0001.mp4
0006_06_0042.mp4
0124_05_0011.mp4
0076_02_0005.mp4
0052_05_0034.mp4
0102_02_0010.mp4
0078_01_0110.mp4
0061_05_0024.mp4
0021_06_0008.mp4
0015_04_0023.mp4
0061_01_0030.mp4
0062_01_0039.mp4
0078_01_0004.mp4
0064_02_0018.mp4
0092_05_0001.mp4
0014_02_0036.mp4
0166_01_0013.mp4
0082_02_0010.mp4
0142_01_0017.mp4
0026_01_0037.mp4
0193_01_0016.mp4
0084_03_0010.mp4
0110_03_0010.mp4
0092_06_0011.mp4
0025_01_0024.mp4
0172_02_0002.mp4
0138_06_0006.mp4
0051_01_0027.mp4
0005_01_0100.mp4
0142_03_0070.mp4
0138_02_0017.mp4
0187_03_0024.mp4
0014_02_0039.mp4
0006_01_0090.mp4
0047_00_0030.mp4
0192_05_0003.mp4
0169_03_0017.mp4
0081_05_0016.mp4
0180_01_0006.mp4
0146_05_0002.mp4
0013_00_0009.mp4
0082_06_0043.mp4
0102_01_0008.mp4
0120_03_0001.mp4
0103_02_0044.mp4
0051_01_0114.mp4
0076_02_0083.mp4
0057_02_0009.mp4
0092_02_0003.mp4
0016_06_0063.mp4
0083_03_0005.mp4
0052_06_0003.mp4
0136_01_0020.mp4
0184_05_0014.mp4
0058_02_0010.mp4
0022_01_0163.mp4
0010_01_0022.mp4
0191_06_0002.mp4
0019_03_0018.mp4
0049_03_0048.mp4
0020_01_0108.mp4
0038_01_0011.mp4
0122_01_0015.mp4
0016_02_0020.mp4
0186_02_0003.mp4
0030_01_0050.mp4
0143_02_0004.mp4
0162_01_0006.mp4
0049_03_0003.mp4
0040_02_0008.mp4
0010_03_0033.mp4
0087_05_0008.mp4
0052_01_0227.mp4
0052_05_0031.mp4
0039_02_0041.mp4
0006_02_0187.mp4
0054_00_0014.mp4
0092_04_0001.mp4
0144_03_0010.mp4
0165_02_0014.mp4
0078_01_0007.mp4
0003_01_0092.mp4
0021_01_0059.mp4
0011_02_0006.mp4
0126_03_0005.mp4
0022_06_0095.mp4
0041_06_0016.mp4
0021_02_0009.mp4
0013_01_0018.mp4
0049_03_0004.mp4
0032_06_0018.mp4
0162_02_0008.mp4
0032_01_0064.mp4
0015_01_0202.mp4
0153_00_0001.mp4
0010_01_0036.mp4
0160_04_0008.mp4
0136_01_0004.mp4
0058_01_0005.mp4
0081_01_0047.mp4
0142_03_0146.mp4
0054_05_0011.mp4
0084_05_0002.mp4
0087_01_0046.mp4
0174_02_0022.mp4
0112_01_0017.mp4
0038_01_0046.mp4
0158_05_0003.mp4
0145_03_0010.mp4
0151_02_0022.mp4
0078_02_0122.mp4
0130_00_0019.mp4
0016_03_0094.mp4
0046_01_0030.mp4
0013_06_0008.mp4
0177_06_0011.mp4
0133_02_0018.mp4
0020_01_0112.mp4
0020_03_0046.mp4
0009_00_0004.mp4
0164_01_0009.mp4
0139_01_0014.mp4
0011_00_0038.mp4
0101_01_0010.mp4
0076_02_0011.mp4
0010_02_0095.mp4
0016_01_0143.mp4
0095_01_0047.mp4
0047_02_0032.mp4
0008_01_0161.mp4
0026_05_0005.mp4
0063_02_0008.mp4
0084_01_0015.mp4
0095_03_0001.mp4
0092_02_0024.mp4
0052_01_0278.mp4
0138_00_0004.mp4
0004_02_0002.mp4
0015_01_0318.mp4
0100_04_0002.mp4
0172_00_0004.mp4
0054_01_0010.mp4
0128_00_0001.mp4
0009_01_0024.mp4
0007_06_0010.mp4
0051_02_0012.mp4
0017_01_0036.mp4
0173_02_0004.mp4
0004_03_0024.mp4
0057_01_0100.mp4
0025_04_0018.mp4
0068_02_0007.mp4
0038_06_0002.mp4
0054_03_0064.mp4
0028_06_0015.mp4
0015_01_0253.mp4
0052_01_0232.mp4
0145_05_0019.mp4
0113_01_0009.mp4
0143_01_0017.mp4
0052_01_0043.mp4
0097_02_0021.mp4
0035_06_0001.mp4
0028_02_0016.mp4
0027_00_0013.mp4
0119_02_0013.mp4
0016_03_0122.mp4
0059_05_0025.mp4
0028_03_0016.mp4
0016_03_0157.mp4
0039_02_0015.mp4
0047_01_0033.mp4
0058_01_0048.mp4
0051_01_0072.mp4
0087_04_0001.mp4
0065_02_0010.mp4
0061_06_0032.mp4
0124_06_0014.mp4
0080_01_0136.mp4
0064_01_0069.mp4
0116_06_0002.mp4
0128_00_0003.mp4
0094_01_0009.mp4
0070_01_0016.mp4
0140_02_0009.mp4
0058_01_0030.mp4
0043_01_0023.mp4
0076_03_0006.mp4
0036_05_0001.mp4
0054_02_0039.mp4
0015_00_0007.mp4
0004_05_0017.mp4
0086_05_0003.mp4
0100_04_0001.mp4
0094_03_0022.mp4
0042_01_0005.mp4
0128_02_0027.mp4
0182_02_0001.mp4
0179_06_0002.mp4
0042_01_0041.mp4
0013_06_0021.mp4
0028_01_0035.mp4
0109_06_0016.mp4
0004_01_0119.mp4
0128_05_0001.mp4
0052_01_0037.mp4
0145_03_0012.mp4
0052_01_0144.mp4
0063_01_0184.mp4
0047_06_0014.mp4
0066_02_0010.mp4
0033_02_0017.mp4
0099_01_0009.mp4
0026_01_0051.mp4
0061_01_0172.mp4
0102_01_0019.mp4
0006_02_0062.mp4
0063_01_0048.mp4
0186_01_0005.mp4
0153_01_0012.mp4
0136_02_0018.mp4
0091_01_0003.mp4
0043_03_0003.mp4
0087_01_0053.mp4
0052_01_0127.mp4
0014_01_0017.mp4
0044_06_0010.mp4
0061_01_0077.mp4
0050_06_0005.mp4
