0168_01_0006.mp4
0029_02_0011.mp4
0173_02_0008.mp4
0008_01_0103.mp4
0074_06_0005.mp4
0018_06_0019.mp4
0097_01_0008.mp4
0069_04_0005.mp4
0035_05_0021.mp4
0106_00_0008.mp4
0120_02_0016.mp4
0005_01_0097.mp4
0063_01_0025.mp4
0028_01_0034.mp4
0089_04_0006.mp4
0167_01_0009.mp4
0094_02_0040.mp4
0135_06_0019.mp4
0080_01_0103.mp4
0017_01_0183.mp4
0052_01_0012.mp4
0029_01_0022.mp4
0185_03_0001.mp4
0016_03_0049.mp4
0082_06_0036.mp4
0071_01_0047.mp4
0086_01_0019.mp4
0172_01_0018.mp4
0039_04_0002.mp4
0064_01_0124.mp4
0142_03_0156.mp4
0164_01_0014.mp4
0079_02_0028.mp4
0108_01_0002.mp4
0070_05_0002.mp4
0015_04_0051.mp4
0076_04_0014.mp4
0036_02_0031.mp4
0091_03_0020.mp4
0167_02_0012.mp4
0151_03_0004.mp4
0046_01_0019.mp4
0166_02_0021.mp4
0183_02_0003.mp4
0007_01_0103.mp4
0075_01_0099.mp4
0004_03_0100.mp4
0014_02_0014.mp4
0126_03_0018.mp4
0049_02_0031.mp4
0132_06_0002.mp4
0089_02_0033.mp4
0027_00_0004.mp4
0104_00_0001.mp4
0086_06_0022.mp4
0113_01_0006.mp4
0009_01_0062.mp4
0004_01_0017.mp4
0017_01_0095.mp4
0140_01_0006.mp4
0092_01_0005.mp4
0153_00_0002.mp4
0081_05_0002.mp4
0019_01_0062.mp4
0006_06_0087.mp4
0076_02_0140.mp4
0010_02_0020.mp4
0138_02_0001.mp4
0111_01_0010.mp4
0061_02_0022.mp4
0004_03_0008.mp4
0087_01_0054.mp4
0151_05_0001.mp4
0013_03_0030.mp4
0061_06_0006.mp4
0049_01_0013.mp4
0017_01_0139.mp4
0020_03_0053.mp4
0081_01_0017.mp4
0062_01_0017.mp4
0161_05_0007.mp4
0020_01_0045.mp4
0025_01_0068.mp4
0032_05_0010.mp4
0084_01_0030.mp4
0109_01_0002.mp4
0068_02_0019.mp4
0102_06_0003.mp4
0134_02_0015.mp4
0003_02_0107.mp4
0094_01_0020.mp4
0006_01_0105.mp4
0084_03_0026.mp4
0006_06_0102.mp4
0041_01_0018.mp4
0097_02_0023.mp4
0120_02_0013.mp4
0007_00_0002.mp4
0168_01_0016.mp4
0019_01_0081.mp4
0187_03_0037.mp4
0059_01_0078.mp4
0052_00_0005.mp4
0161_01_0021.mp4
0052_01_0152.mp4
0042_01_0047.mp4
0116_01_0005.mp4
0061_00_0003.mp4
0186_04_0001.mp4
0068_06_0005.mp4
0061_06_0055.mp4
0112_02_0012.mp4
0129_01_0012.mp4
0046_03_0035.mp4
0112_02_0025.mp4
0033_06_0005.mp4
0015_00_0002.mp4
0016_01_0094.mp4
0145_01_0014.mp4
0075_02_0003.mp4
0054_05_0040.mp4
0033_02_0011.mp4
0178_03_0016.mp4
0163_01_0004.mp4
0136_02_0029.mp4
0034_04_0003.mp4
0039_00_0002.mp4
0032_01_0067.mp4
0096_01_0031.mp4
0137_03_0008.mp4
0052_01_0004.mp4
0036_01_0028.mp4
0081_05_0011.mp4
0010_03_0056.mp4
0182_05_0008.mp4
0006_06_0010.mp4
0080_01_0146.mp4
0070_01_0050.mp4
0010_01_0100.mp4
0131_00_0003.mp4
0012_01_0030.mp4
0032_02_0003.mp4
0062_06_0006.mp4
0143_02_0007.mp4
0015_01_0027.mp4
0192_02_0004.mp4
0072_01_0071.mp4
0103_04_0012.mp4
0078_03_0020.mp4
0118_03_0008.mp4
0057_02_0005.mp4
0031_02_0021.mp4
0093_02_0032.mp4
0090_01_0007.mp4
0030_01_0025.mp4
0035_05_0019.mp4
0016_03_0070.mp4
0064_05_0015.mp4
0070_01_0147.mp4
0009_01_0037.mp4
0133_01_0013.mp4
0177_06_0012.mp4
0006_01_0109.mp4
0026_05_0010.mp4
0006_02_0146.mp4
0074_01_0001.mp4
0145_01_0005.mp4
0031_00_0002.mp4
0062_01_0036.mp4
0003_02_0049.mp4
0168_02_0005.mp4
0103_04_0003.mp4
0035_06_0033.mp4
0089_02_0005.mp4
0122_02_0004.mp4
0021_02_0053.mp4
0113_05_0004.mp4
0015_01_0163.mp4
0037_05_0015.mp4
0029_01_0013.mp4
0020_00_0008.mp4
0038_02_0021.mp4
0011_01_0004.mp4
0011_00_0013.mp4
0106_04_0003.mp4
0080_01_0153.mp4
0016_00_0079.mp4
0069_02_0022.mp4
0006_02_0135.mp4
0064_05_0002.mp4
0022_01_0088.mp4
0052_01_0151.mp4
0009_01_0018.mp4
0137_02_0006.mp4
0069_01_0030.mp4
0087_06_0014.mp4
0144_03_0012.mp4
0037_01_0016.mp4
0150_06_0002.mp4
0078_01_0065.mp4
0164_06_0004.mp4
0185_01_0009.mp4
0063_01_0024.mp4
0074_02_0014.mp4
0014_01_0015.mp4
0054_02_0033.mp4
0191_05_0004.mp4
0064_06_0010.mp4
0146_01_0007.mp4
0015_04_0011.mp4
0090_01_0010.mp4
0052_06_0002.mp4
0116_03_0013.mp4
0042_01_0034.mp4
0082_06_0051.mp4
0081_01_0039.mp4
0102_01_0017.mp4
0032_01_0032.mp4
0078_01_0020.mp4
0094_00_0011.mp4
0118_00_0002.mp4
0136_04_0001.mp4
0022_01_0061.mp4
0059_01_0116.mp4
0031_02_0016.mp4
0061_06_0015.mp4
0157_03_0002.mp4
0089_02_0020.mp4
0022_06_0111.mp4
0097_06_0021.mp4
0089_01_0047.mp4
0117_01_0014.mp4
0119_01_0007.mp4
0025_01_0049.mp4
0120_01_0022.mp4
0060_01_0079.mp4
0107_01_0018.mp4
0004_03_0052.mp4
0062_01_0035.mp4
0038_02_0027.mp4
0022_01_0046.mp4
0022_01_0136.mp4
0140_03_0016.mp4
0029_05_0003.mp4
0172_06_0009.mp4
0017_01_0107.mp4
0010_03_0052.mp4
0081_06_0010.mp4
0069_01_0103.mp4
0080_01_0106.mp4
0039_06_0003.mp4
0051_01_0103.mp4
0038_06_0015.mp4
0008_01_0090.mp4
0104_04_0001.mp4
0064_01_0043.mp4
0054_01_0016.mp4
0126_03_0002.mp4
0007_01_0004.mp4
0071_01_0030.mp4
0129_03_0006.mp4
0022_01_0171.mp4
0054_01_0011.mp4
0058_01_0011.mp4
0179_01_0007.mp4
0189_01_0019.mp4
0029_03_0006.mp4
0080_01_0114.mp4
0007_01_0136.mp4
0061_06_0004.mp4
0079_01_0004.mp4
0008_01_0208.mp4
0182_05_0017.mp4
0052_01_0141.mp4
0082_06_0018.mp4
0073_01_0017.mp4
0006_01_0077.mp4
0036_06_0009.mp4
0022_01_0284.mp4
0021_01_0026.mp4
0080_01_0099.mp4
0188_03_0019.mp4
0016_03_0212.mp4
0089_00_0008.mp4
0010_03_0022.mp4
0018_06_0033.mp4
0021_02_0089.mp4
0119_06_0022.mp4
0112_06_0006.mp4
0081_02_0057.mp4
0121_05_0003.mp4
0004_01_0035.mp4
0009_01_0103.mp4
0075_01_0103.mp4
0143_02_0031.mp4
0054_05_0005.mp4
0018_06_0053.mp4
0142_03_0140.mp4
0107_01_0024.mp4
0021_02_0099.mp4
0049_03_0070.mp4
0070_01_0058.mp4
0089_02_0039.mp4
0075_01_0106.mp4
0015_01_0236.mp4
0164_02_0010.mp4
0052_01_0128.mp4
0021_01_0043.mp4
0004_01_0160.mp4
0065_05_0003.mp4
0072_02_0021.mp4
0119_03_0013.mp4
0005_05_0011.mp4
0164_05_0001.mp4
0052_01_0027.mp4
0139_02_0017.mp4
0100_01_0045.mp4
0084_01_0001.mp4
0079_01_0028.mp4
0174_03_0022.mp4
0178_05_0011.mp4
0028_06_0005.mp4
0039_01_0055.mp4
0005_01_0011.mp4
0110_00_0019.mp4
0010_02_0131.mp4
0104_06_0007.mp4
0070_01_0139.mp4
0110_03_0014.mp4
0097_06_0015.mp4
0021_00_0002.mp4
0048_02_0097.mp4
0132_01_0017.mp4
0022_02_0014.mp4
0015_01_0066.mp4
0108_01_0013.mp4
0141_01_0011.mp4
0042_01_0037.mp4
0052_02_0006.mp4
0047_02_0050.mp4
0036_06_0011.mp4
0008_01_0014.mp4
0059_01_0118.mp4
0135_01_0012.mp4
0081_02_0041.mp4
0115_06_0006.mp4
0184_02_0021.mp4
0054_02_0037.mp4
0048_03_0019.mp4
0016_00_0054.mp4
0020_03_0037.mp4
0095_02_0001.mp4
0080_01_0117.mp4
0074_03_0010.mp4
0046_02_0004.mp4
0064_02_0004.mp4
0106_03_0022.mp4
0018_06_0039.mp4
0172_02_0012.mp4
0021_02_0014.mp4
0123_02_0005.mp4
0009_02_0008.mp4
0193_03_0021.mp4
0029_01_0008.mp4
0013_02_0021.mp4
0050_01_0003.mp4
0078_02_0135.mp4
0112_03_0003.mp4
0081_01_0020.mp4
0019_01_0096.mp4
0011_01_0005.mp4
0006_03_0016.mp4
0143_05_0002.mp4
0159_02_0013.mp4
0015_04_0012.mp4
