0019_01_0074.mp4
0011_00_0010.mp4
0025_03_0037.mp4
0054_00_0035.mp4
0102_01_0043.mp4
0078_01_0055.mp4
0042_02_0014.mp4
0174_01_0001.mp4
0192_00_0004.mp4
0078_02_0109.mp4
0057_01_0142.mp4
0060_01_0103.mp4
0049_01_0008.mp4
0126_03_0020.mp4
0061_01_0165.mp4
0133_05_0008.mp4
0092_02_0012.mp4
0052_03_0027.mp4
0064_02_0006.mp4
0192_05_0004.mp4
0070_01_0130.mp4
0029_03_0001.mp4
0016_00_0059.mp4
0141_01_0013.mp4
0015_01_0203.mp4
0106_02_0016.mp4
0058_01_0049.mp4
0022_01_0068.mp4
0097_03_0007.mp4
0048_01_0028.mp4
0177_02_0009.mp4
0191_00_0008.mp4
0052_01_0291.mp4
0051_01_0049.mp4
0015_01_0060.mp4
0157_01_0004.mp4
0118_05_0006.mp4
0032_01_0061.mp4
0107_01_0015.mp4
0078_02_0129.mp4
0124_02_0044.mp4
0075_00_0013.mp4
0066_00_0010.mp4
0015_01_0089.mp4
0010_02_0212.mp4
0025_01_0011.mp4
0016_03_0224.mp4
0064_01_0189.mp4
0080_01_0008.mp4
0019_01_0063.mp4
0047_02_0077.mp4
0010_01_0042.mp4
0087_06_0016.mp4
0057_06_0003.mp4
0048_02_0001.mp4
0032_01_0057.mp4
0053_02_0017.mp4
0051_01_0029.mp4
0118_05_0004.mp4
0004_03_0031.mp4
0059_02_0010.mp4
0116_04_0008.mp4
0131_01_0010.mp4
0051_01_0166.mp4
0135_06_0025.mp4
0139_05_0002.mp4
0032_02_0001.mp4
0019_01_0053.mp4
0082_02_0015.mp4
0096_03_0002.mp4
0082_03_0003.mp4
0030_04_0003.mp4
0062_02_0005.mp4
0089_02_0056.mp4
0145_01_0025.mp4
0063_01_0049.mp4
0161_05_0020.mp4
0107_01_0005.mp4
0047_06_0002.mp4
0080_01_0003.mp4
0016_03_0008.mp4
0018_02_0008.mp4
0138_03_0020.mp4
0082_06_0021.mp4
0003_02_0016.mp4
0078_02_0146.mp4
0015_01_0319.mp4
0080_01_0098.mp4
0061_01_0067.mp4
0166_02_0013.mp4
0187_02_0005.mp4
0071_01_0009.mp4
0043_01_0021.mp4
0080_01_0127.mp4
0113_02_0008.mp4
0064_05_0024.mp4
0018_06_0052.mp4
0096_01_0079.mp4
0005_01_0004.mp4
0061_01_0022.mp4
0061_02_0090.mp4
0030_02_0085.mp4
0016_06_0035.mp4
0138_02_0007.mp4
0102_05_0002.mp4
0006_02_0173.mp4
0063_02_0005.mp4
0020_06_0006.mp4
0162_03_0003.mp4
0089_01_0008.mp4
0109_01_0022.mp4
0059_01_0003.mp4
0052_01_0195.mp4
0020_02_0005.mp4
0103_06_0006.mp4
0010_01_0067.mp4
0126_01_0010.mp4
0047_00_0008.mp4
0103_02_0009.mp4
0069_01_0041.mp4
0049_03_0076.mp4
0089_02_0040.mp4
0036_01_0030.mp4
0064_01_0200.mp4
0062_01_0018.mp4
0014_01_0076.mp4
0094_06_0005.mp4
0006_01_0087.mp4
0103_01_0031.mp4
0067_03_0014.mp4
0064_05_0007.mp4
0005_03_0020.mp4
0010_02_0133.mp4
0126_01_0001.mp4
0046_01_0022.mp4
0064_01_0151.mp4
0022_01_0092.mp4
0131_02_0001.mp4
0015_01_0023.mp4
0121_01_0004.mp4
0076_02_0105.mp4
0136_01_0014.mp4
0117_01_0004.mp4
0015_01_0053.mp4
0032_02_0031.mp4
0061_00_0001.mp4
0058_01_0018.mp4
0134_01_0001.mp4
0153_06_0008.mp4
0094_02_0042.mp4
0085_01_0039.mp4
0075_01_0014.mp4
0063_01_0165.mp4
0037_00_0001.mp4
0170_00_0008.mp4
0107_02_0024.mp4
0060_01_0033.mp4
0015_01_0210.mp4
0064_01_0186.mp4
0010_03_0044.mp4
0036_01_0006.mp4
0080_01_0040.mp4
0192_02_0014.mp4
0077_05_0015.mp4
0013_01_0003.mp4
0006_04_0001.mp4
0142_03_0094.mp4
0135_02_0010.mp4
0030_00_0003.mp4
0057_01_0133.mp4
0088_02_0013.mp4
0113_02_0011.mp4
0008_01_0108.mp4
0140_01_0003.mp4
0142_00_0002.mp4
0027_00_0010.mp4
0082_01_0051.mp4
0013_02_0024.mp4
0144_04_0005.mp4
0183_01_0007.mp4
0004_01_0156.mp4
0007_01_0048.mp4
0035_01_0008.mp4
0005_01_0023.mp4
0022_01_0239.mp4
0143_05_0006.mp4
0057_01_0032.mp4
0104_03_0002.mp4
0009_01_0122.mp4
0074_01_0016.mp4
0085_01_0096.mp4
0064_05_0017.mp4
0025_01_0056.mp4
0097_00_0005.mp4
0032_05_0011.mp4
0068_00_0018.mp4
0010_01_0015.mp4
0058_01_0016.mp4
0021_06_0004.mp4
0112_04_0008.mp4
0091_03_0032.mp4
0180_02_0024.mp4
0179_04_0002.mp4
0032_01_0082.mp4
0171_05_0003.mp4
0008_01_0182.mp4
0022_01_0222.mp4
0140_02_0012.mp4
0175_04_0001.mp4
0040_02_0004.mp4
0082_02_0008.mp4
0003_01_0011.mp4
0010_01_0057.mp4
0180_02_0008.mp4
0052_01_0176.mp4
0078_06_0053.mp4
0177_06_0013.mp4
0178_01_0026.mp4
0097_01_0020.mp4
0075_02_0035.mp4
0047_00_0012.mp4
0103_02_0017.mp4
0015_01_0168.mp4
0052_01_0009.mp4
0005_00_0002.mp4
0015_01_0195.mp4
0016_02_0002.mp4
0010_01_0046.mp4
0163_03_0009.mp4
0006_06_0074.mp4
0119_05_0001.mp4
0057_01_0081.mp4
0008_01_0016.mp4
0016_00_0012.mp4
0018_06_0041.mp4
0077_03_0003.mp4
0003_02_0097.mp4
0133_00_0019.mp4
0010_03_0043.mp4
0016_03_0162.mp4
0049_03_0075.mp4
0174_03_0025.mp4
0032_02_0009.mp4
0017_02_0005.mp4
0151_03_0011.mp4
0022_01_0176.mp4
0076_02_0032.mp4
0102_04_0004.mp4
0191_01_0009.mp4
0070_01_0111.mp4
0090_01_0009.mp4
0069_01_0090.mp4
0061_06_0058.mp4
0059_01_0027.mp4
0026_02_0021.mp4
0067_03_0005.mp4
0191_01_0007.mp4
0026_02_0012.mp4
0088_02_0020.mp4
0124_02_0004.mp4
0089_01_0005.mp4
0152_02_0008.mp4
0017_01_0031.mp4
0080_02_0010.mp4
0086_02_0007.mp4
0059_01_0057.mp4
0142_03_0131.mp4
0172_02_0007.mp4
0143_06_0002.mp4
0028_05_0010.mp4
0014_01_0002.mp4
0009_01_0040.mp4
0041_03_0001.mp4
0012_06_0053.mp4
0010_01_0088.mp4
0072_01_0054.mp4
0052_03_0026.mp4
0075_01_0054.mp4
0109_05_0007.mp4
0031_06_0011.mp4
0010_03_0002.mp4
0113_02_0022.mp4
0077_01_0024.mp4
0070_01_0087.mp4
0066_02_0002.mp4
0058_01_0003.mp4
0092_03_0016.mp4
0016_03_0050.mp4
0026_01_0023.mp4
0048_03_0018.mp4
0063_01_0158.mp4
0076_01_0003.mp4
0004_01_0038.mp4
0189_06_0005.mp4
0157_04_0001.mp4
0160_02_0009.mp4
0030_01_0009.mp4
0008_05_0003.mp4
0014_01_0101.mp4
0103_01_0047.mp4
0166_02_0028.mp4
0009_01_0095.mp4
0067_06_0007.mp4
0015_01_0152.mp4
0015_01_0330.mp4
0166_02_0018.mp4
0102_06_0018.mp4
0016_03_0161.mp4
0074_01_0013.mp4
0118_03_0010.mp4
0051_01_0127.mp4
0014_03_0006.mp4
0165_05_0005.mp4
0019_06_0032.mp4
0017_01_0037.mp4
0004_05_0028.mp4
0013_03_0019.mp4
0059_05_0014.mp4
0041_02_0009.mp4
0103_01_0048.mp4
0015_01_0171.mp4
0084_02_0009.mp4
0006_06_0002.mp4
0006_06_0058.mp4
0153_06_0005.mp4
0110_01_0013.mp4
0074_01_0025.mp4
0170_02_0005.mp4
0085_03_0006.mp4
0070_06_0017.mp4
0116_01_0002.mp4
0071_05_0009.mp4
0021_05_0004.mp4
0127_01_0005.mp4
0120_03_0037.mp4
0015_01_0256.mp4
0006_02_0095.mp4
0007_01_0108.mp4
0178_06_0006.mp4
0155_01_0006.mp4
0014_03_0005.mp4
0010_03_0045.mp4
0075_01_0064.mp4
0052_02_0011.mp4
0162_05_0003.mp4
0013_01_0023.mp4
0015_01_0049.mp4
0063_01_0156.mp4
0087_04_0002.mp4
0110_02_0006.mp4
0101_01_0016.mp4
0115_01_0004.mp4
0074_02_0048.mp4
0142_02_0006.mp4
0020_06_0001.mp4
0053_01_0002.mp4
0080_01_0143.mp4
0057_01_0124.mp4
0133_02_0019.mp4
0054_02_0020.mp4
0071_01_0075.mp4
0064_01_0030.mp4
0063_01_0052.mp4
0018_03_0007.mp4
0063_01_0172.mp4
0110_01_0018.mp4
0136_02_0024.mp4
0109_01_0011.mp4
0061_00_0002.mp4
0047_04_0005.mp4
0077_01_0013.mp4
0052_01_0214.mp4
0101_01_0004.mp4
0087_01_0040.mp4
0015_01_0052.mp4
