0075_02_0071.mp4
0010_03_0058.mp4
0066_01_0023.mp4
0130_06_0003.mp4
0103_02_0035.mp4
0156_00_0003.mp4
0118_01_0011.mp4
0071_05_0005.mp4
0017_01_0112.mp4
0025_01_0045.mp4
0081_02_0039.mp4
0103_01_0007.mp4
0004_01_0037.mp4
0016_03_0137.mp4
0061_03_0008.mp4
0053_01_0026.mp4
0047_02_0120.mp4
0019_01_0004.mp4
0032_06_0022.mp4
0057_01_0083.mp4
0031_03_0017.mp4
0004_01_0036.mp4
0009_01_0035.mp4
0075_02_0006.mp4
0036_02_0047.mp4
0007_06_0006.mp4
0059_00_0008.mp4
0114_06_0001.mp4
0098_01_0011.mp4
0144_02_0017.mp4
0052_01_0237.mp4
0016_01_0023.mp4
0177_05_0003.mp4
0064_01_0134.mp4
0016_01_0130.mp4
0108_00_0004.mp4
0035_05_0011.mp4
0051_01_0148.mp4
0078_02_0052.mp4
0162_02_0017.mp4
0097_06_0007.mp4
0080_01_0093.mp4
0084_06_0016.mp4
0051_01_0109.mp4
0013_01_0027.mp4
0008_01_0119.mp4
0185_00_0002.mp4
0021_01_0025.mp4
0008_01_0191.mp4
0013_05_0005.mp4
0145_03_0017.mp4
0135_06_0004.mp4
0159_00_0001.mp4
0059_01_0098.mp4
0070_01_0046.mp4
0021_02_0019.mp4
0063_04_0001.mp4
0153_01_0010.mp4
0079_01_0012.mp4
0071_01_0028.mp4
0035_04_0019.mp4
0116_04_0003.mp4
0014_02_0051.mp4
0006_02_0133.mp4
0019_03_0002.mp4
0010_02_0225.mp4
0076_02_0012.mp4
0135_01_0005.mp4
0019_06_0010.mp4
0026_01_0035.mp4
0003_02_0135.mp4
0065_01_0030.mp4
0063_01_0167.mp4
0059_01_0013.mp4
0051_01_0153.mp4
0026_01_0005.mp4
0159_01_0002.mp4
0050_01_0017.mp4
0006_01_0102.mp4
0129_02_0008.mp4
0132_05_0002.mp4
0081_01_0055.mp4
0038_02_0008.mp4
0138_01_0004.mp4
0179_00_0008.mp4
0016_02_0023.mp4
0069_03_0005.mp4
0129_01_0003.mp4
0065_00_0007.mp4
0016_00_0060.mp4
0038_00_0033.mp4
0096_02_0026.mp4
0020_06_0033.mp4
0034_03_0001.mp4
0106_02_0014.mp4
0139_02_0019.mp4
0182_05_0001.mp4
0065_02_0007.mp4
0059_02_0001.mp4
0170_06_0012.mp4
0157_02_0006.mp4
0008_01_0162.mp4
0080_01_0057.mp4
0066_01_0009.mp4
0161_00_0005.mp4
0016_03_0207.mp4
0061_05_0016.mp4
0133_00_0016.mp4
0133_00_0014.mp4
0142_03_0028.mp4
0010_01_0029.mp4
0129_01_0008.mp4
0017_01_0136.mp4
0070_01_0137.mp4
0015_01_0132.mp4
0081_05_0009.mp4
0161_06_0010.mp4
0013_06_0014.mp4
0163_01_0027.mp4
0010_02_0146.mp4
0094_02_0015.mp4
0020_03_0072.mp4
0070_02_0014.mp4
0047_02_0105.mp4
0149_02_0006.mp4
0080_03_0004.mp4
0059_02_0002.mp4
0015_01_0064.mp4
0078_02_0119.mp4
0076_00_0018.mp4
0087_03_0086.mp4
0063_01_0139.mp4
0078_02_0042.mp4
0039_01_0018.mp4
0087_02_0078.mp4
0081_02_0024.mp4
0035_04_0012.mp4
0126_02_0006.mp4
0171_06_0002.mp4
0015_01_0201.mp4
0081_02_0028.mp4
0105_01_0024.mp4
0189_02_0011.mp4
0054_02_0058.mp4
0116_04_0004.mp4
0146_01_0008.mp4
0072_00_0023.mp4
0061_01_0177.mp4
0124_02_0009.mp4
0163_02_0006.mp4
0051_03_0010.mp4
0017_01_0029.mp4
0010_02_0104.mp4
0020_01_0085.mp4
0061_01_0074.mp4
0013_01_0004.mp4
0011_00_0017.mp4
0085_01_0004.mp4
0100_02_0011.mp4
0016_00_0046.mp4
0080_01_0158.mp4
0076_02_0046.mp4
0095_03_0009.mp4
0010_01_0049.mp4
0006_02_0144.mp4
0089_00_0006.mp4
0173_01_0002.mp4
0112_00_0006.mp4
0007_02_0001.mp4
0036_04_0001.mp4
0104_05_0002.mp4
0087_03_0006.mp4
0016_00_0086.mp4
0144_03_0002.mp4
0108_02_0012.mp4
0069_00_0010.mp4
0086_05_0006.mp4
0094_05_0001.mp4
0010_02_0024.mp4
0016_01_0128.mp4
0114_01_0002.mp4
0079_03_0055.mp4
0017_01_0040.mp4
0008_01_0188.mp4
0049_03_0031.mp4
0022_06_0110.mp4
0004_03_0075.mp4
0061_01_0133.mp4
0142_05_0002.mp4
0041_02_0029.mp4
0067_03_0032.mp4
0004_03_0047.mp4
0017_02_0006.mp4
0006_01_0088.mp4
0016_00_0110.mp4
0025_00_0003.mp4
0155_03_0001.mp4
0153_01_0004.mp4
0017_01_0132.mp4
0019_06_0065.mp4
0052_01_0073.mp4
0003_01_0101.mp4
0145_03_0006.mp4
0175_06_0003.mp4
0159_04_0001.mp4
0040_01_0008.mp4
0035_05_0023.mp4
0142_03_0026.mp4
0032_01_0051.mp4
0128_01_0015.mp4
0172_02_0004.mp4
0031_06_0020.mp4
0134_02_0014.mp4
0017_01_0017.mp4
0043_01_0031.mp4
0180_05_0004.mp4
0186_02_0004.mp4
0005_02_0018.mp4
0146_00_0003.mp4
0169_02_0003.mp4
0014_02_0048.mp4
0087_06_0024.mp4
0016_03_0206.mp4
0028_00_0002.mp4
0052_01_0021.mp4
0075_03_0012.mp4
0010_01_0043.mp4
0067_03_0045.mp4
0122_01_0013.mp4
0069_03_0001.mp4
0015_01_0204.mp4
0069_01_0019.mp4
0041_01_0006.mp4
0085_01_0057.mp4
0085_01_0001.mp4
0035_06_0031.mp4
0070_01_0068.mp4
0006_03_0003.mp4
0052_01_0150.mp4
0078_00_0009.mp4
0100_01_0047.mp4
0015_01_0197.mp4
0174_03_0028.mp4
0020_06_0025.mp4
0142_03_0082.mp4
0078_06_0055.mp4
0120_03_0011.mp4
0070_01_0083.mp4
0087_03_0092.mp4
0074_02_0032.mp4
0018_06_0036.mp4
0119_05_0011.mp4
0159_02_0006.mp4
0015_01_0150.mp4
0016_03_0030.mp4
0101_01_0027.mp4
0057_02_0017.mp4
0006_06_0051.mp4
0007_06_0003.mp4
0019_01_0082.mp4
0016_03_0045.mp4
0078_01_0003.mp4
0057_01_0099.mp4
0090_03_0002.mp4
0010_02_0014.mp4
0036_03_0014.mp4
0153_01_0003.mp4
0061_03_0007.mp4
0133_00_0009.mp4
0006_01_0064.mp4
0093_01_0040.mp4
0040_02_0015.mp4
0016_00_0062.mp4
0070_01_0110.mp4
0072_00_0026.mp4
0190_05_0006.mp4
0048_03_0003.mp4
0070_00_0005.mp4
0163_00_0013.mp4
0016_06_0025.mp4
0119_04_0005.mp4
0049_02_0033.mp4
0004_03_0018.mp4
0075_01_0096.mp4
0014_02_0011.mp4
0069_01_0111.mp4
0129_04_0004.mp4
0075_02_0081.mp4
0038_01_0040.mp4
0019_02_0023.mp4
0011_06_0001.mp4
0092_01_0007.mp4
0016_03_0002.mp4
0063_01_0127.mp4
0155_01_0001.mp4
0096_02_0002.mp4
0047_03_0070.mp4
0022_01_0114.mp4
0051_01_0130.mp4
0104_01_0007.mp4
0116_05_0001.mp4
0069_01_0113.mp4
0172_02_0010.mp4
0017_02_0019.mp4
0030_02_0089.mp4
0025_01_0040.mp4
0161_05_0017.mp4
0061_02_0055.mp4
0054_03_0008.mp4
0014_02_0004.mp4
0017_01_0186.mp4
0192_01_0001.mp4
0139_04_0004.mp4
0006_03_0022.mp4
0084_01_0024.mp4
0059_01_0012.mp4
0007_01_0013.mp4
0015_01_0147.mp4
0018_06_0065.mp4
0047_01_0008.mp4
0028_01_0005.mp4
0036_01_0052.mp4
0065_02_0019.mp4
0151_05_0004.mp4
0187_03_0049.mp4
0052_03_0008.mp4
0102_06_0005.mp4
0151_02_0024.mp4
0008_01_0101.mp4
0158_02_0002.mp4
0004_01_0047.mp4
0051_02_0016.mp4
0184_01_0008.mp4
0005_03_0005.mp4
0054_03_0022.mp4
0054_03_0040.mp4
0138_02_0003.mp4
0192_05_0006.mp4
0137_01_0009.mp4
0072_01_0010.mp4
0041_02_0010.mp4
0015_06_0012.mp4
0097_01_0005.mp4
0072_02_0023.mp4
0030_02_0035.mp4
0057_01_0097.mp4
0088_03_0028.mp4
0047_00_0015.mp4
0080_01_0100.mp4
0057_01_0004.mp4
0142_03_0093.mp4
0064_01_0144.mp4
0084_01_0056.mp4
0011_00_0032.mp4
0021_02_0040.mp4
0123_03_0012.mp4
0052_05_0015.mp4
0091_01_0016.mp4
0004_01_0088.mp4
0047_02_0116.mp4
0089_01_0045.mp4
0047_02_0076.mp4
0089_02_0054.mp4
0039_05_0002.mp4
0019_06_0003.mp4
0141_01_0003.mp4
0103_01_0014.mp4
0042_01_0020.mp4
0179_04_0003.mp4
0152_05_0004.mp4
0012_06_0015.mp4
0025_01_0021.mp4
0022_02_0011.mp4
0026_00_0015.mp4
0170_06_0008.mp4
