0059_03_0014.mp4
0129_05_0001.mp4
0054_03_0029.mp4
0020_01_0138.mp4
0064_05_0013.mp4
0166_00_0006.mp4
0052_01_0070.mp4
0175_00_0001.mp4
0072_01_0069.mp4
0186_04_0006.mp4
0039_01_0076.mp4
0076_01_0023.mp4
0068_02_0013.mp4
0010_02_0170.mp4
0005_00_0001.mp4
0082_01_0080.mp4
0068_02_0010.mp4
0075_02_0084.mp4
0073_01_0010.mp4
0015_01_0145.mp4
0091_01_0006.mp4
0004_03_0035.mp4
0030_01_0054.mp4
0190_05_0001.mp4
0137_03_0013.mp4
0078_01_0021.mp4
0003_02_0004.mp4
0135_01_0010.mp4
0059_01_0008.mp4
0102_06_0009.mp4
0149_02_0005.mp4
0020_06_0007.mp4
0143_01_0004.mp4
0017_01_0057.mp4
0019_02_0025.mp4
0015_01_0255.mp4
0101_02_0012.mp4
0133_03_0014.mp4
0057_01_0001.mp4
0022_01_0199.mp4
0071_01_0061.mp4
0053_06_0007.mp4
0164_02_0014.mp4
0139_01_0018.mp4
0009_06_0006.mp4
0054_03_0066.mp4
0004_01_0184.mp4
0010_01_0008.mp4
0003_01_0035.mp4
0077_01_0011.mp4
0019_06_0079.mp4
0060_01_0041.mp4
0064_02_0016.mp4
0045_01_0019.mp4
0078_02_0034.mp4
0066_01_0012.mp4
0120_05_0011.mp4
0010_02_0076.mp4
0025_02_0013.mp4
0072_03_0004.mp4
0063_01_0106.mp4
0103_01_0045.mp4
0147_02_0007.mp4
0139_02_0050.mp4
0174_02_0018.mp4
0158_02_0008.mp4
0059_01_0058.mp4
0123_01_0002.mp4
0006_02_0075.mp4
0107_00_0014.mp4
0015_04_0036.mp4
0048_03_0009.mp4
0109_05_0011.mp4
0049_02_0003.mp4
0022_01_0115.mp4
0169_01_0008.mp4
0100_01_0050.mp4
0142_01_0018.mp4
0095_01_0053.mp4
0020_01_0015.mp4
0006_02_0184.mp4
0091_01_0044.mp4
0035_01_0004.mp4
0175_05_0014.mp4
0027_06_0030.mp4
0026_05_0004.mp4
0022_01_0023.mp4
0020_01_0133.mp4
0087_06_0006.mp4
0076_02_0048.mp4
0054_03_0051.mp4
0071_03_0022.mp4
0067_01_0002.mp4
0106_01_0011.mp4
0013_01_0002.mp4
0014_01_0106.mp4
0032_01_0084.mp4
0111_01_0019.mp4
0095_01_0003.mp4
0179_02_0015.mp4
0076_02_0002.mp4
0080_01_0085.mp4
0105_01_0008.mp4
0064_06_0015.mp4
0138_02_0012.mp4
0025_01_0002.mp4
0006_02_0010.mp4
0085_00_0002.mp4
0122_02_0005.mp4
0176_02_0002.mp4
0095_02_0011.mp4
0065_02_0016.mp4
0076_02_0123.mp4
0155_00_0002.mp4
0016_03_0211.mp4
0059_02_0021.mp4
0007_01_0018.mp4
0061_02_0056.mp4
0097_02_0014.mp4
0038_02_0035.mp4
0080_03_0011.mp4
0178_05_0005.mp4
0016_03_0109.mp4
0045_02_0012.mp4
0003_01_0102.mp4
0141_03_0012.mp4
0046_03_0073.mp4
0046_03_0005.mp4
0061_05_0012.mp4
0100_01_0041.mp4
0166_05_0003.mp4
0003_01_0065.mp4
0107_01_0012.mp4
0081_02_0060.mp4
0009_03_0009.mp4
0159_01_0025.mp4
0119_05_0007.mp4
0141_02_0018.mp4
0148_01_0026.mp4
0020_06_0010.mp4
0085_01_0003.mp4
0171_01_0017.mp4
0078_06_0044.mp4
0010_03_0070.mp4
0013_01_0014.mp4
0118_02_0023.mp4
0089_01_0031.mp4
0022_01_0231.mp4
0098_02_0001.mp4
0103_01_0026.mp4
0028_01_0013.mp4
0120_00_0016.mp4
0088_03_0017.mp4
0012_06_0065.mp4
0163_01_0010.mp4
0028_03_0003.mp4
0054_01_0005.mp4
0007_01_0118.mp4
0163_02_0009.mp4
0060_02_0004.mp4
0009_01_0101.mp4
0174_02_0021.mp4
0078_02_0106.mp4
0184_03_0001.mp4
0069_01_0075.mp4
0061_01_0014.mp4
0061_01_0072.mp4
0069_01_0083.mp4
0085_01_0085.mp4
0038_02_0032.mp4
0185_01_0005.mp4
0004_02_0006.mp4
0038_01_0036.mp4
0081_01_0050.mp4
0032_01_0035.mp4
0030_01_0005.mp4
0139_02_0032.mp4
0137_02_0025.mp4
0014_01_0120.mp4
0009_01_0091.mp4
0187_06_0005.mp4
0082_01_0061.mp4
0116_02_0011.mp4
0039_02_0048.mp4
0010_03_0031.mp4
0124_02_0002.mp4
0072_05_0011.mp4
0020_01_0041.mp4
0075_00_0025.mp4
0013_02_0028.mp4
0039_02_0017.mp4
0110_02_0008.mp4
0020_03_0058.mp4
0102_06_0013.mp4
0036_02_0020.mp4
0158_02_0006.mp4
0119_00_0013.mp4
0057_01_0085.mp4
0047_06_0007.mp4
0075_02_0015.mp4
0052_01_0126.mp4
0068_01_0006.mp4
0089_03_0048.mp4
0078_01_0008.mp4
0048_01_0024.mp4
0016_05_0003.mp4
0005_02_0016.mp4
0039_01_0017.mp4
0038_01_0048.mp4
0009_01_0029.mp4
0054_02_0003.mp4
0005_01_0047.mp4
0048_03_0020.mp4
0050_03_0008.mp4
0052_03_0002.mp4
0158_05_0001.mp4
0021_01_0058.mp4
0186_04_0007.mp4
0150_04_0005.mp4
0031_01_0004.mp4
0087_02_0094.mp4
0016_06_0018.mp4
0080_01_0069.mp4
0141_02_0003.mp4
0054_02_0052.mp4
0191_02_0027.mp4
0159_02_0014.mp4
0102_01_0033.mp4
0015_01_0310.mp4
0064_01_0014.mp4
0016_01_0034.mp4
0096_01_0096.mp4
0018_06_0011.mp4
0004_01_0029.mp4
0128_02_0005.mp4
0074_03_0032.mp4
0120_03_0050.mp4
0015_01_0134.mp4
0166_02_0026.mp4
0010_02_0195.mp4
0120_01_0009.mp4
0059_01_0079.mp4
0059_02_0035.mp4
0070_01_0172.mp4
0109_05_0001.mp4
0040_03_0001.mp4
0061_06_0057.mp4
0010_02_0144.mp4
0041_02_0041.mp4
0184_03_0007.mp4
0025_05_0011.mp4
0164_02_0007.mp4
0133_02_0004.mp4
0153_02_0002.mp4
0182_03_0003.mp4
0052_01_0251.mp4
0018_00_0006.mp4
0004_02_0020.mp4
0014_03_0012.mp4
0136_00_0006.mp4
0008_05_0007.mp4
0083_02_0003.mp4
0012_00_0002.mp4
0018_06_0067.mp4
0059_00_0005.mp4
0166_01_0001.mp4
0031_06_0032.mp4
0119_00_0004.mp4
0088_01_0008.mp4
0054_02_0022.mp4
0119_03_0006.mp4
0021_02_0073.mp4
0014_03_0004.mp4
0192_02_0012.mp4
0049_03_0093.mp4
0052_01_0119.mp4
0088_05_0009.mp4
0142_03_0150.mp4
0116_02_0020.mp4
0057_01_0116.mp4
0010_03_0081.mp4
0087_02_0062.mp4
0010_02_0160.mp4
0100_06_0009.mp4
0169_06_0004.mp4
0065_02_0001.mp4
0067_02_0010.mp4
0051_01_0065.mp4
0139_01_0011.mp4
0010_02_0213.mp4
0074_05_0009.mp4
0142_03_0128.mp4
0091_01_0009.mp4
0107_02_0039.mp4
0135_01_0011.mp4
0021_01_0046.mp4
0035_00_0018.mp4
0144_02_0010.mp4
0052_03_0023.mp4
0016_03_0143.mp4
0032_02_0005.mp4
0086_03_0017.mp4
0081_02_0068.mp4
0138_02_0024.mp4
0007_02_0020.mp4
0163_02_0017.mp4
0088_03_0023.mp4
0022_03_0008.mp4
0011_06_0022.mp4
0074_02_0012.mp4
0063_01_0171.mp4
0052_01_0079.mp4
0093_02_0042.mp4
0086_03_0002.mp4
0017_01_0104.mp4
0006_02_0141.mp4
0019_01_0029.mp4
0155_06_0008.mp4
0016_03_0086.mp4
0020_03_0032.mp4
0025_02_0042.mp4
0025_01_0052.mp4
0101_01_0026.mp4
0054_04_0009.mp4
0192_01_0005.mp4
0030_01_0008.mp4
0059_01_0105.mp4
0022_01_0194.mp4
0104_01_0013.mp4
0134_03_0007.mp4
0061_04_0014.mp4
0005_01_0076.mp4
0004_01_0143.mp4
0115_02_0010.mp4
0104_01_0027.mp4
0047_00_0029.mp4
0062_02_0021.mp4
0148_06_0003.mp4
0076_02_0080.mp4
0049_03_0051.mp4
0092_02_0022.mp4
0182_06_0002.mp4
0146_02_0012.mp4
0047_02_0082.mp4
0028_01_0014.mp4
0101_01_0022.mp4
0082_01_0056.mp4
0130_00_0003.mp4
0078_06_0003.mp4
0009_01_0006.mp4
0078_01_0069.mp4
0054_03_0069.mp4
0169_01_0002.mp4
0006_03_0020.mp4
0061_02_0018.mp4
0039_05_0009.mp4
0110_01_0009.mp4
0078_02_0068.mp4
0082_06_0002.mp4
0019_03_0004.mp4
0006_02_0112.mp4
0165_05_0007.mp4
0017_01_0076.mp4
0121_03_0017.mp4
0061_03_0024.mp4
0064_01_0170.mp4
0069_01_0051.mp4
0004_01_0081.mp4
0010_03_0019.mp4
0075_02_0032.mp4
0051_02_0014.mp4
0071_01_0109.mp4
0128_02_0011.mp4
0163_05_0004.mp4
0171_00_0006.mp4
