0085_02_0009.mp4
0072_00_0022.mp4
0110_00_0018.mp4
0077_01_0012.mp4
0004_01_0164.mp4
0040_06_0011.mp4
0038_01_0016.mp4
0020_03_0067.mp4
0122_01_0002.mp4
0022_06_0019.mp4
0148_02_0031.mp4
0115_01_0012.mp4
0011_00_0031.mp4
0060_01_0089.mp4
0087_02_0104.mp4
0143_03_0015.mp4
0067_05_0007.mp4
0074_00_0011.mp4
0187_04_0002.mp4
0064_01_0006.mp4
0016_03_0046.mp4
0005_03_0019.mp4
0187_03_0043.mp4
0063_01_0045.mp4
0036_03_0009.mp4
0025_01_0013.mp4
0013_03_0031.mp4
0118_03_0012.mp4
0004_01_0189.mp4
0078_02_0126.mp4
0022_06_0041.mp4
0169_01_0006.mp4
0106_03_0002.mp4
0022_06_0105.mp4
0077_03_0004.mp4
0065_03_0003.mp4
0174_03_0018.mp4
0085_01_0002.mp4
0060_01_0072.mp4
0052_05_0028.mp4
0072_05_0006.mp4
0035_04_0018.mp4
0104_01_0008.mp4
0006_06_0007.mp4
0016_03_0182.mp4
0103_04_0007.mp4
0082_06_0022.mp4
0074_03_0013.mp4
0063_01_0046.mp4
0063_01_0065.mp4
0030_01_0043.mp4
0075_02_0075.mp4
0153_00_0004.mp4
0169_01_0011.mp4
0115_01_0013.mp4
0187_03_0023.mp4
0090_01_0011.mp4
0102_01_0009.mp4
0047_01_0014.mp4
0030_02_0036.mp4
0007_01_0111.mp4
0151_01_0010.mp4
0030_02_0051.mp4
0061_01_0181.mp4
0084_01_0021.mp4
0085_02_0044.mp4
0067_01_0001.mp4
0007_01_0072.mp4
0022_01_0245.mp4
0010_02_0117.mp4
0011_00_0034.mp4
0096_01_0063.mp4
0019_06_0071.mp4
0151_06_0007.mp4
0063_01_0169.mp4
0082_02_0016.mp4
0059_00_0012.mp4
0127_01_0012.mp4
0054_05_0022.mp4
0072_01_0013.mp4
0161_01_0018.mp4
0006_01_0071.mp4
0078_02_0091.mp4
0059_01_0093.mp4
0141_05_0001.mp4
0191_03_0004.mp4
0075_01_0039.mp4
0052_01_0220.mp4
0051_01_0043.mp4
0193_01_0013.mp4
0005_01_0098.mp4
0153_06_0009.mp4
0070_06_0011.mp4
0063_01_0166.mp4
0092_03_0015.mp4
0088_06_0007.mp4
0192_03_0017.mp4
0016_01_0121.mp4
0121_01_0017.mp4
0074_02_0034.mp4
0035_06_0029.mp4
0022_06_0102.mp4
0112_02_0005.mp4
0113_01_0016.mp4
0119_02_0012.mp4
0061_01_0011.mp4
0093_01_0022.mp4
0078_02_0137.mp4
0057_06_0006.mp4
0128_01_0002.mp4
0008_01_0064.mp4
0087_01_0050.mp4
0043_04_0001.mp4
0085_02_0028.mp4
0065_02_0014.mp4
0184_01_0005.mp4
0006_06_0090.mp4
0016_00_0076.mp4
0052_01_0284.mp4
0030_02_0062.mp4
0185_05_0002.mp4
0105_01_0012.mp4
0137_03_0019.mp4
0017_01_0088.mp4
0097_02_0011.mp4
0094_03_0009.mp4
0054_00_0008.mp4
0136_06_0010.mp4
0087_01_0034.mp4
0078_01_0050.mp4
0012_03_0008.mp4
0025_02_0057.mp4
0039_01_0073.mp4
0144_01_0019.mp4
0008_01_0046.mp4
0066_00_0003.mp4
0188_03_0008.mp4
0075_01_0008.mp4
0085_01_0049.mp4
0102_02_0020.mp4
0092_01_0009.mp4
0064_02_0001.mp4
0004_01_0144.mp4
0146_02_0013.mp4
0016_00_0026.mp4
0016_01_0024.mp4
0020_02_0009.mp4
0189_02_0009.mp4
0089_03_0036.mp4
0130_00_0013.mp4
0048_01_0001.mp4
0132_02_0008.mp4
0054_05_0036.mp4
0064_01_0172.mp4
0153_05_0004.mp4
0076_02_0041.mp4
0076_01_0037.mp4
0038_00_0005.mp4
0038_02_0009.mp4
0026_00_0011.mp4
0017_01_0051.mp4
0051_06_0009.mp4
0179_06_0012.mp4
0112_00_0016.mp4
0140_03_0029.mp4
0064_01_0112.mp4
0016_03_0145.mp4
0057_02_0011.mp4
0022_01_0029.mp4
0193_01_0002.mp4
0076_02_0051.mp4
0027_01_0028.mp4
0022_01_0045.mp4
0072_03_0011.mp4
0021_02_0026.mp4
0025_01_0060.mp4
0074_02_0013.mp4
0076_01_0042.mp4
0075_00_0032.mp4
0132_02_0011.mp4
0022_01_0261.mp4
0047_02_0027.mp4
0154_06_0004.mp4
0150_02_0017.mp4
0148_02_0016.mp4
0119_05_0028.mp4
0116_02_0013.mp4
0035_01_0001.mp4
0039_01_0041.mp4
0078_02_0022.mp4
0077_01_0010.mp4
0008_01_0196.mp4
0032_01_0060.mp4
0052_01_0131.mp4
0060_01_0106.mp4
0126_01_0002.mp4
0182_06_0003.mp4
0060_01_0071.mp4
0049_01_0010.mp4
0148_04_0001.mp4
0015_01_0054.mp4
0028_03_0017.mp4
0049_03_0052.mp4
0016_03_0015.mp4
0078_01_0100.mp4
0008_01_0089.mp4
0048_02_0017.mp4
0182_02_0012.mp4
0099_01_0001.mp4
0097_05_0004.mp4
0006_05_0002.mp4
0139_02_0023.mp4
0132_01_0019.mp4
0017_05_0010.mp4
0070_01_0170.mp4
0006_02_0081.mp4
0026_05_0009.mp4
0072_02_0017.mp4
0071_02_0002.mp4
0148_01_0001.mp4
0006_02_0123.mp4
0040_02_0023.mp4
0061_06_0025.mp4
0044_06_0020.mp4
0015_04_0015.mp4
0004_00_0002.mp4
0006_05_0011.mp4
0057_01_0122.mp4
0070_01_0171.mp4
0026_02_0023.mp4
0110_01_0001.mp4
0158_02_0004.mp4
0154_02_0010.mp4
0139_02_0018.mp4
0044_02_0011.mp4
0028_06_0023.mp4
0052_02_0014.mp4
0004_03_0081.mp4
0008_01_0107.mp4
0015_01_0094.mp4
0042_06_0014.mp4
0075_06_0003.mp4
0015_01_0265.mp4
0139_05_0011.mp4
0104_01_0021.mp4
0136_02_0008.mp4
0005_03_0004.mp4
0155_01_0011.mp4
0048_02_0090.mp4
0063_01_0002.mp4
0061_01_0110.mp4
0022_01_0006.mp4
0031_06_0010.mp4
0073_00_0002.mp4
0019_02_0051.mp4
0063_01_0091.mp4
0012_01_0029.mp4
0052_01_0016.mp4
0046_02_0012.mp4
0086_06_0030.mp4
0081_01_0011.mp4
0109_01_0015.mp4
0163_03_0011.mp4
0071_01_0066.mp4
0021_03_0003.mp4
0078_01_0031.mp4
0138_03_0018.mp4
0026_01_0055.mp4
0059_01_0039.mp4
0157_02_0010.mp4
0192_06_0008.mp4
0027_06_0031.mp4
0047_02_0048.mp4
0090_02_0001.mp4
0038_03_0001.mp4
0026_02_0034.mp4
0097_02_0010.mp4
0109_05_0004.mp4
0020_01_0060.mp4
0161_06_0006.mp4
0060_01_0076.mp4
0184_01_0009.mp4
0098_01_0002.mp4
0078_02_0013.mp4
0071_05_0006.mp4
0057_01_0010.mp4
0081_05_0017.mp4
0040_02_0027.mp4
0022_01_0032.mp4
0022_06_0099.mp4
0092_03_0019.mp4
0087_01_0005.mp4
0052_01_0245.mp4
0015_01_0061.mp4
0044_03_0001.mp4
0051_01_0089.mp4
0140_03_0022.mp4
0080_01_0145.mp4
0036_01_0043.mp4
0042_06_0013.mp4
0078_01_0074.mp4
0070_01_0140.mp4
0068_01_0009.mp4
0025_04_0011.mp4
0027_06_0004.mp4
0004_01_0138.mp4
0015_01_0122.mp4
0190_04_0001.mp4
0022_06_0092.mp4
0052_01_0133.mp4
0162_01_0005.mp4
0091_03_0044.mp4
0177_01_0004.mp4
0010_01_0102.mp4
0114_03_0005.mp4
0050_05_0002.mp4
0112_01_0005.mp4
0025_02_0056.mp4
0006_02_0107.mp4
0089_00_0007.mp4
0134_04_0004.mp4
0173_01_0016.mp4
0134_02_0019.mp4
0007_06_0019.mp4
0047_00_0013.mp4
0095_01_0048.mp4
0164_02_0008.mp4
0070_01_0004.mp4
0061_01_0045.mp4
0175_01_0010.mp4
0055_00_0003.mp4
0177_03_0009.mp4
0053_05_0004.mp4
0187_03_0063.mp4
0003_02_0072.mp4
0016_03_0191.mp4
0084_01_0034.mp4
0010_01_0026.mp4
0127_01_0004.mp4
0019_01_0035.mp4
0150_02_0013.mp4
0004_01_0033.mp4
0142_01_0009.mp4
0139_02_0029.mp4
0060_01_0036.mp4
0016_03_0085.mp4
0135_06_0020.mp4
0016_00_0081.mp4
0071_01_0059.mp4
0082_03_0002.mp4
0120_00_0020.mp4
0109_01_0016.mp4
0042_01_0013.mp4
0017_01_0038.mp4
0010_01_0053.mp4
0087_02_0072.mp4
0088_05_0010.mp4
0005_02_0011.mp4
0107_02_0043.mp4
0012_06_0039.mp4
0189_01_0010.mp4
0091_02_0013.mp4
0091_01_0013.mp4
0041_01_0024.mp4
0015_04_0013.mp4
0048_02_0050.mp4
0008_01_0038.mp4
0039_02_0007.mp4
0178_04_0003.mp4
0165_00_0008.mp4
0154_01_0001.mp4
0036_03_0018.mp4
0168_02_0015.mp4
0138_02_0014.mp4
0010_01_0052.mp4
