0018_02_0007.mp4
0102_01_0012.mp4
0113_01_0002.mp4
0121_03_0002.mp4
0087_06_0009.mp4
0052_01_0285.mp4
0063_01_0013.mp4
0016_00_0025.mp4
0055_01_0004.mp4
0004_01_0083.mp4
0006_06_0061.mp4
0145_03_0007.mp4
0027_02_0008.mp4
0102_02_0007.mp4
0075_02_0070.mp4
0006_06_0030.mp4
0025_01_0050.mp4
0078_06_0009.mp4
0139_01_0009.mp4
0006_06_0056.mp4
0119_01_0001.mp4
0157_03_0004.mp4
0014_01_0112.mp4
0010_01_0009.mp4
0052_02_0013.mp4
0137_06_0005.mp4
0052_05_0004.mp4
0030_02_0047.mp4
0095_01_0034.mp4
0094_03_0008.mp4
0077_04_0002.mp4
0021_02_0037.mp4
0186_02_0011.mp4
0003_02_0099.mp4
0019_01_0013.mp4
0167_00_0001.mp4
0093_03_0001.mp4
0061_06_0016.mp4
0078_02_0027.mp4
0015_01_0235.mp4
0008_01_0190.mp4
0192_01_0010.mp4
0165_03_0012.mp4
0117_00_0017.mp4
0008_01_0145.mp4
0042_06_0010.mp4
0164_03_0017.mp4
0016_00_0093.mp4
0019_01_0005.mp4
0051_01_0096.mp4
0051_01_0079.mp4
0161_01_0019.mp4
0030_06_0002.mp4
0174_05_0002.mp4
0095_03_0014.mp4
0047_03_0045.mp4
0084_03_0020.mp4
0064_01_0168.mp4
0012_06_0017.mp4
0148_02_0012.mp4
0007_01_0099.mp4
0053_04_0021.mp4
0144_01_0009.mp4
0173_02_0007.mp4
0154_01_0010.mp4
0071_03_0013.mp4
0121_02_0009.mp4
0139_05_0004.mp4
0052_05_0023.mp4
0051_01_0160.mp4
0064_05_0003.mp4
0096_01_0015.mp4
0135_06_0011.mp4
0100_01_0039.mp4
0032_01_0054.mp4
0053_01_0005.mp4
0054_05_0023.mp4
0038_01_0013.mp4
0055_01_0008.mp4
0052_01_0129.mp4
0045_02_0002.mp4
0192_02_0008.mp4
0097_02_0018.mp4
0049_02_0032.mp4
0187_01_0009.mp4
0123_02_0014.mp4
0064_01_0019.mp4
0118_02_0025.mp4
0089_01_0048.mp4
0022_06_0073.mp4
0059_03_0004.mp4
0071_01_0043.mp4
0113_02_0017.mp4
0095_02_0014.mp4
0191_02_0032.mp4
0032_01_0055.mp4
0110_03_0002.mp4
0019_01_0036.mp4
0174_03_0020.mp4
0093_01_0043.mp4
0154_03_0005.mp4
0078_01_0064.mp4
0031_03_0001.mp4
0078_02_0015.mp4
0020_03_0041.mp4
0078_06_0045.mp4
0178_04_0005.mp4
0084_01_0032.mp4
0005_01_0038.mp4
0028_01_0030.mp4
0016_00_0108.mp4
0006_02_0155.mp4
0042_02_0022.mp4
0020_01_0059.mp4
0145_02_0014.mp4
0113_00_0006.mp4
0022_02_0031.mp4
0096_01_0041.mp4
0166_02_0005.mp4
0179_02_0003.mp4
0049_03_0037.mp4
0094_02_0023.mp4
0140_03_0010.mp4
0058_02_0011.mp4
0078_02_0132.mp4
0016_00_0103.mp4
0061_06_0051.mp4
0069_06_0003.mp4
0004_04_0001.mp4
0094_02_0030.mp4
0057_01_0031.mp4
0100_01_0074.mp4
0118_01_0004.mp4
0107_01_0002.mp4
0106_02_0008.mp4
0169_02_0013.mp4
0057_01_0005.mp4
0075_01_0034.mp4
0179_05_0011.mp4
0060_01_0105.mp4
0061_03_0004.mp4
0153_02_0013.mp4
0109_02_0020.mp4
0020_01_0105.mp4
0088_04_0003.mp4
0110_03_0018.mp4
0094_01_0023.mp4
0145_06_0001.mp4
0018_06_0074.mp4
0006_06_0100.mp4
0153_02_0009.mp4
0163_03_0004.mp4
0103_02_0023.mp4
0076_02_0037.mp4
0107_00_0010.mp4
0030_02_0033.mp4
0019_06_0047.mp4
0069_01_0106.mp4
0130_00_0012.mp4
0063_01_0144.mp4
0070_01_0150.mp4
0075_01_0075.mp4
0192_06_0005.mp4
0017_01_0102.mp4
0016_03_0106.mp4
0052_01_0149.mp4
0124_05_0002.mp4
0087_01_0039.mp4
0104_06_0012.mp4
0073_01_0021.mp4
0150_04_0003.mp4
0164_02_0011.mp4
0182_02_0016.mp4
0069_01_0012.mp4
0028_06_0032.mp4
0008_01_0156.mp4
0076_02_0007.mp4
0007_06_0001.mp4
0069_01_0117.mp4
0076_02_0114.mp4
0154_01_0013.mp4
0182_03_0004.mp4
0018_02_0001.mp4
0081_02_0050.mp4
0016_00_0028.mp4
0004_01_0048.mp4
0119_04_0007.mp4
0175_01_0009.mp4
0093_01_0003.mp4
0102_01_0041.mp4
0052_01_0190.mp4
0152_01_0004.mp4
0008_01_0093.mp4
0065_05_0001.mp4
0147_01_0001.mp4
0042_01_0016.mp4
0184_00_0001.mp4
0105_01_0023.mp4
0075_01_0049.mp4
0014_02_0003.mp4
0005_06_0003.mp4
0103_01_0006.mp4
0059_00_0011.mp4
0103_01_0049.mp4
0091_03_0005.mp4
0109_01_0020.mp4
0103_01_0036.mp4
0021_02_0092.mp4
0028_00_0003.mp4
0059_02_0009.mp4
0061_02_0083.mp4
0021_02_0103.mp4
0046_01_0031.mp4
0078_06_0019.mp4
0072_02_0008.mp4
0053_04_0004.mp4
0008_01_0143.mp4
0015_01_0138.mp4
0019_02_0027.mp4
0187_03_0083.mp4
0087_01_0015.mp4
0050_01_0019.mp4
0016_03_0219.mp4
0091_02_0008.mp4
0042_02_0005.mp4
0060_01_0123.mp4
0015_06_0002.mp4
0136_03_0032.mp4
0109_02_0001.mp4
0152_05_0005.mp4
0017_01_0167.mp4
0150_00_0005.mp4
0064_01_0138.mp4
0060_02_0002.mp4
0059_02_0004.mp4
0019_06_0021.mp4
0189_02_0020.mp4
0031_03_0004.mp4
0091_00_0001.mp4
0167_02_0008.mp4
0078_02_0107.mp4
0083_03_0025.mp4
0021_02_0041.mp4
0010_01_0028.mp4
0011_00_0002.mp4
0150_00_0006.mp4
0054_05_0015.mp4
0177_06_0014.mp4
0193_05_0008.mp4
0097_00_0006.mp4
0156_06_0001.mp4
0053_02_0007.mp4
0180_02_0018.mp4
0103_01_0030.mp4
0006_02_0121.mp4
0139_02_0037.mp4
0032_06_0004.mp4
0049_03_0006.mp4
0145_05_0012.mp4
0165_01_0005.mp4
0006_02_0049.mp4
0007_01_0068.mp4
0133_06_0005.mp4
0063_01_0088.mp4
0022_06_0001.mp4
0020_06_0017.mp4
0022_01_0259.mp4
0104_01_0031.mp4
0177_00_0010.mp4
0118_03_0011.mp4
0143_03_0017.mp4
0016_06_0094.mp4
0051_02_0015.mp4
0162_00_0009.mp4
0030_00_0007.mp4
0047_01_0007.mp4
0012_06_0013.mp4
0052_01_0266.mp4
0110_03_0005.mp4
0064_01_0160.mp4
0038_01_0037.mp4
0061_01_0087.mp4
0022_01_0036.mp4
0186_01_0006.mp4
0176_01_0001.mp4
0020_03_0084.mp4
0110_02_0001.mp4
0016_06_0059.mp4
0009_01_0053.mp4
0185_00_0011.mp4
0081_06_0011.mp4
0017_01_0108.mp4
0026_01_0053.mp4
0126_02_0003.mp4
0017_01_0091.mp4
0064_01_0108.mp4
0110_01_0007.mp4
0091_01_0039.mp4
0087_01_0025.mp4
0143_03_0005.mp4
0060_01_0059.mp4
0017_00_0005.mp4
0011_00_0030.mp4
0078_01_0035.mp4
0148_02_0023.mp4
0113_03_0004.mp4
0095_02_0047.mp4
0162_01_0007.mp4
0178_02_0001.mp4
0010_02_0105.mp4
0014_01_0003.mp4
0017_01_0128.mp4
0180_03_0002.mp4
0173_02_0009.mp4
0070_01_0014.mp4
0128_01_0005.mp4
0166_06_0001.mp4
0147_02_0015.mp4
0102_01_0014.mp4
0179_05_0012.mp4
0019_01_0061.mp4
0030_02_0094.mp4
0175_05_0012.mp4
0172_02_0005.mp4
0106_05_0006.mp4
0068_04_0001.mp4
0022_06_0104.mp4
0021_02_0023.mp4
0057_01_0038.mp4
0053_04_0016.mp4
0120_06_0008.mp4
0124_05_0007.mp4
0010_02_0077.mp4
0064_02_0005.mp4
0060_02_0008.mp4
0014_01_0061.mp4
0085_01_0078.mp4
0022_06_0051.mp4
0087_03_0011.mp4
0166_01_0012.mp4
0173_00_0004.mp4
0016_03_0221.mp4
0030_02_0070.mp4
0101_00_0001.mp4
0052_02_0018.mp4
0035_03_0017.mp4
0085_02_0037.mp4
0048_02_0040.mp4
0048_02_0095.mp4
0016_03_0076.mp4
0148_02_0028.mp4
0074_00_0006.mp4
0110_01_0017.mp4
0103_01_0060.mp4
0027_01_0032.mp4
0006_01_0093.mp4
0161_06_0005.mp4
0046_06_0006.mp4
0052_01_0120.mp4
0059_03_0025.mp4
0075_02_0096.mp4
0069_02_0024.mp4
0116_01_0015.mp4
0019_01_0018.mp4
0012_01_0023.mp4
0085_01_0023.mp4
0070_01_0122.mp4
0070_01_0082.mp4
0087_01_0023.mp4
0020_05_0001.mp4
0006_02_0183.mp4
0135_03_0020.mp4
0072_01_0058.mp4
0069_00_0012.mp4
0069_01_0128.mp4
