0019_06_0028.mp4
0064_02_0020.mp4
0047_02_0119.mp4
0086_01_0023.mp4
0176_00_0002.mp4
0052_01_0168.mp4
0078_01_0043.mp4
0141_00_0009.mp4
0078_05_0006.mp4
0052_01_0177.mp4
0070_01_0037.mp4
0182_02_0002.mp4
0058_04_0001.mp4
0008_01_0157.mp4
0076_01_0030.mp4
0115_02_0008.mp4
0004_03_0086.mp4
0051_01_0064.mp4
0128_02_0016.mp4
0015_01_0298.mp4
0093_01_0026.mp4
0064_01_0137.mp4
0172_02_0001.mp4
0011_00_0011.mp4
0017_00_0001.mp4
0142_02_0018.mp4
0190_06_0007.mp4
0087_06_0015.mp4
0070_06_0027.mp4
0018_00_0010.mp4
0015_01_0226.mp4
0006_02_0046.mp4
0063_01_0014.mp4
0193_03_0008.mp4
0010_03_0082.mp4
0119_03_0015.mp4
0170_02_0011.mp4
0140_03_0005.mp4
0048_02_0083.mp4
0078_01_0127.mp4
0146_05_0005.mp4
0019_06_0001.mp4
0050_00_0002.mp4
0096_01_0076.mp4
0124_02_0017.mp4
0032_02_0006.mp4
0066_02_0020.mp4
0062_02_0014.mp4
0052_02_0010.mp4
0054_00_0017.mp4
0042_01_0001.mp4
0186_01_0011.mp4
0170_01_0003.mp4
0165_03_0003.mp4
0121_03_0020.mp4
0130_00_0006.mp4
0022_01_0015.mp4
0060_01_0104.mp4
0064_01_0195.mp4
0051_01_0086.mp4
0047_02_0017.mp4
0014_01_0099.mp4
0128_02_0023.mp4
0066_02_0023.mp4
0010_02_0130.mp4
0063_01_0042.mp4
0136_02_0019.mp4
0064_01_0054.mp4
0078_01_0072.mp4
0067_02_0002.mp4
0059_01_0111.mp4
0088_06_0004.mp4
0015_01_0250.mp4
0016_00_0074.mp4
0060_01_0034.mp4
0052_01_0051.mp4
0069_06_0004.mp4
0066_05_0003.mp4
0021_02_0007.mp4
0051_02_0001.mp4
0101_02_0014.mp4
0086_01_0016.mp4
0047_03_0025.mp4
0070_02_0013.mp4
0064_06_0014.mp4
0057_01_0080.mp4
0032_01_0023.mp4
0010_02_0206.mp4
0010_02_0136.mp4
0038_02_0017.mp4
0020_01_0035.mp4
0022_06_0013.mp4
0030_02_0031.mp4
0018_06_0066.mp4
0104_02_0024.mp4
0072_01_0004.mp4
0064_01_0167.mp4
0078_02_0030.mp4
0086_02_0042.mp4
0028_03_0011.mp4
0047_02_0019.mp4
0099_02_0013.mp4
0057_01_0125.mp4
0140_05_0001.mp4
0061_04_0001.mp4
0028_05_0036.mp4
0151_01_0016.mp4
0010_02_0048.mp4
0069_01_0098.mp4
0014_01_0025.mp4
0120_01_0015.mp4
0064_01_0155.mp4
0014_01_0090.mp4
0101_01_0014.mp4
0164_06_0014.mp4
0042_01_0045.mp4
0054_01_0020.mp4
0081_01_0051.mp4
0052_01_0046.mp4
0006_01_0028.mp4
0069_05_0011.mp4
0049_03_0026.mp4
0185_06_0001.mp4
0093_01_0025.mp4
0151_05_0005.mp4
0047_02_0020.mp4
0054_02_0054.mp4
0061_05_0004.mp4
0039_01_0023.mp4
0038_01_0025.mp4
0160_06_0009.mp4
0010_01_0070.mp4
0054_02_0045.mp4
0063_01_0037.mp4
0060_01_0044.mp4
0005_06_0006.mp4
0152_05_0001.mp4
0085_02_0030.mp4
0009_01_0005.mp4
0087_06_0004.mp4
0067_03_0038.mp4
0079_02_0008.mp4
0092_02_0023.mp4
0039_01_0020.mp4
0016_00_0043.mp4
0087_03_0017.mp4
0139_01_0003.mp4
0015_01_0021.mp4
0186_02_0009.mp4
0058_01_0007.mp4
0017_01_0053.mp4
0009_00_0002.mp4
0080_01_0073.mp4
0068_02_0006.mp4
0070_01_0094.mp4
0067_03_0039.mp4
0010_03_0010.mp4
0184_05_0002.mp4
0113_02_0019.mp4
0096_01_0065.mp4
0078_02_0036.mp4
0147_02_0004.mp4
0027_02_0034.mp4
0048_02_0068.mp4
0051_01_0172.mp4
0020_01_0007.mp4
0060_01_0048.mp4
0025_02_0038.mp4
0022_03_0002.mp4
0104_03_0001.mp4
0143_05_0013.mp4
0061_05_0011.mp4
0127_02_0002.mp4
0008_01_0096.mp4
0009_01_0099.mp4
0038_02_0010.mp4
0067_03_0022.mp4
0076_02_0008.mp4
0151_06_0005.mp4
0067_03_0033.mp4
0177_02_0004.mp4
0116_02_0008.mp4
0059_01_0041.mp4
0107_06_0007.mp4
0052_01_0155.mp4
0142_03_0031.mp4
0038_05_0005.mp4
0016_01_0039.mp4
0173_01_0009.mp4
0026_01_0042.mp4
0022_02_0030.mp4
0114_01_0003.mp4
0063_01_0027.mp4
0105_03_0006.mp4
0015_02_0009.mp4
0052_01_0183.mp4
0047_02_0081.mp4
0020_03_0062.mp4
0119_06_0005.mp4
0059_01_0029.mp4
0151_06_0015.mp4
0089_03_0007.mp4
0134_03_0008.mp4
0003_01_0002.mp4
0137_03_0003.mp4
0148_01_0002.mp4
0005_01_0002.mp4
0032_01_0011.mp4
0078_06_0008.mp4
0008_01_0160.mp4
0004_01_0067.mp4
0155_00_0003.mp4
0070_01_0135.mp4
0085_01_0033.mp4
0161_03_0005.mp4
0134_01_0011.mp4
0037_05_0014.mp4
0046_03_0058.mp4
0079_06_0010.mp4
0038_00_0024.mp4
0052_03_0025.mp4
0132_01_0013.mp4
0036_06_0015.mp4
0081_05_0006.mp4
0155_02_0003.mp4
0016_03_0067.mp4
0030_04_0015.mp4
0027_06_0021.mp4
0171_02_0005.mp4
0051_06_0011.mp4
0193_06_0001.mp4
0047_02_0059.mp4
0006_01_0068.mp4
0019_01_0064.mp4
0022_01_0145.mp4
0016_03_0148.mp4
0140_03_0031.mp4
0083_05_0009.mp4
0071_01_0015.mp4
0096_01_0058.mp4
0107_01_0029.mp4
0133_02_0015.mp4
0040_04_0004.mp4
0047_02_0039.mp4
0012_06_0004.mp4
0061_01_0054.mp4
0003_02_0122.mp4
0115_04_0001.mp4
0058_01_0038.mp4
0080_02_0009.mp4
0093_01_0041.mp4
0028_03_0012.mp4
0061_01_0017.mp4
0063_01_0105.mp4
0062_00_0005.mp4
0022_06_0059.mp4
0042_01_0022.mp4
0016_06_0062.mp4
0137_02_0030.mp4
0078_02_0075.mp4
0167_02_0011.mp4
0008_01_0063.mp4
0084_01_0045.mp4
0065_01_0007.mp4
0064_01_0089.mp4
0162_05_0011.mp4
0048_02_0005.mp4
0022_01_0275.mp4
0063_01_0008.mp4
0016_01_0056.mp4
0052_01_0221.mp4
0069_00_0001.mp4
0168_03_0015.mp4
0070_01_0117.mp4
0082_01_0022.mp4
0048_03_0017.mp4
0150_00_0007.mp4
0087_05_0002.mp4
0105_05_0003.mp4
0021_02_0011.mp4
0061_02_0087.mp4
0180_05_0002.mp4
0006_02_0156.mp4
0098_01_0010.mp4
0036_02_0043.mp4
0031_06_0033.mp4
0009_01_0087.mp4
0043_03_0023.mp4
0042_01_0046.mp4
0094_02_0035.mp4
0109_05_0008.mp4
0064_01_0018.mp4
0004_03_0033.mp4
0089_01_0034.mp4
0144_02_0006.mp4
0074_03_0017.mp4
0133_01_0004.mp4
0058_01_0012.mp4
0014_02_0021.mp4
0088_04_0001.mp4
0063_01_0148.mp4
0052_01_0280.mp4
0081_01_0052.mp4
0087_05_0005.mp4
0113_05_0001.mp4
0032_01_0071.mp4
0008_01_0175.mp4
0012_06_0058.mp4
0006_02_0088.mp4
0069_01_0034.mp4
0175_01_0011.mp4
0010_02_0129.mp4
0009_01_0089.mp4
0013_02_0032.mp4
0179_00_0010.mp4
0112_05_0005.mp4
0032_06_0007.mp4
0076_01_0034.mp4
0041_05_0009.mp4
0110_01_0003.mp4
0124_02_0025.mp4
0018_06_0042.mp4
0082_03_0004.mp4
0030_02_0066.mp4
0030_02_0075.mp4
0193_03_0035.mp4
0014_02_0043.mp4
0107_06_0009.mp4
0077_05_0017.mp4
0163_01_0003.mp4
0008_01_0019.mp4
0069_02_0006.mp4
0018_02_0004.mp4
0059_01_0070.mp4
0175_05_0026.mp4
0091_05_0001.mp4
0130_00_0016.mp4
0013_06_0011.mp4
0124_01_0023.mp4
0061_06_0061.mp4
0110_05_0006.mp4
0003_02_0085.mp4
0005_05_0007.mp4
0088_02_0014.mp4
0008_01_0059.mp4
0188_04_0001.mp4
0070_01_0022.mp4
0034_04_0005.mp4
0021_01_0051.mp4
0063_01_0109.mp4
0147_01_0014.mp4
0100_02_0016.mp4
0019_06_0081.mp4
0005_01_0073.mp4
0014_01_0042.mp4
0077_01_0031.mp4
0008_01_0121.mp4
0153_05_0003.mp4
0114_03_0001.mp4
0177_02_0002.mp4
0020_01_0071.mp4
0146_02_0004.mp4
0016_03_0016.mp4
0061_01_0075.mp4
0017_01_0084.mp4
0087_03_0079.mp4
0078_01_0106.mp4
0122_02_0024.mp4
0087_06_0010.mp4
0047_03_0011.mp4
0074_03_0020.mp4
0007_05_0010.mp4
0011_01_0001.mp4
0045_02_0020.mp4
0062_06_0012.mp4
