0168_01_0008.mp4
0119_06_0013.mp4
0043_01_0015.mp4
0182_06_0009.mp4
0066_02_0004.mp4
0025_01_0004.mp4
0004_01_0057.mp4
0019_01_0071.mp4
0064_05_0018.mp4
0059_01_0119.mp4
0013_01_0040.mp4
0015_01_0040.mp4
0135_01_0009.mp4
0019_01_0087.mp4
0051_01_0022.mp4
0175_06_0005.mp4
0036_02_0003.mp4
0123_00_0004.mp4
0010_01_0039.mp4
0061_04_0009.mp4
0026_02_0032.mp4
0128_00_0004.mp4
0191_02_0024.mp4
0015_01_0216.mp4
0038_00_0016.mp4
0026_01_0039.mp4
0003_01_0099.mp4
0031_03_0006.mp4
0004_02_0018.mp4
0118_00_0003.mp4
0142_02_0019.mp4
0161_02_0007.mp4
0035_04_0003.mp4
0066_02_0022.mp4
0006_02_0153.mp4
0059_01_0083.mp4
0115_03_0002.mp4
0063_05_0001.mp4
0067_03_0002.mp4
0047_03_0061.mp4
0075_06_0008.mp4
0027_02_0012.mp4
0017_01_0069.mp4
0094_02_0039.mp4
0038_00_0001.mp4
0017_02_0013.mp4
0028_05_0025.mp4
0099_00_0001.mp4
0031_02_0036.mp4
0028_05_0029.mp4
0075_02_0090.mp4
0066_01_0007.mp4
0111_01_0008.mp4
0116_04_0009.mp4
0182_02_0014.mp4
0062_01_0038.mp4
0053_02_0014.mp4
0008_01_0170.mp4
0070_01_0009.mp4
0092_02_0025.mp4
0031_02_0047.mp4
0017_01_0035.mp4
0136_01_0012.mp4
0186_01_0007.mp4
0040_00_0010.mp4
0022_01_0256.mp4
0008_01_0210.mp4
0031_03_0007.mp4
0012_03_0003.mp4
0049_03_0092.mp4
0016_02_0006.mp4
0006_01_0094.mp4
0019_02_0001.mp4
0140_01_0005.mp4
0189_01_0006.mp4
0130_05_0004.mp4
0013_06_0016.mp4
0046_01_0010.mp4
0060_01_0096.mp4
0082_01_0085.mp4
0162_02_0002.mp4
0022_01_0226.mp4
0017_01_0086.mp4
0017_01_0145.mp4
0047_00_0011.mp4
0124_02_0003.mp4
0045_02_0017.mp4
0118_05_0002.mp4
0025_02_0037.mp4
0112_05_0006.mp4
0016_01_0031.mp4
0013_01_0046.mp4
0006_03_0006.mp4
0014_01_0057.mp4
0078_06_0022.mp4
0113_02_0009.mp4
0006_01_0060.mp4
0049_03_0055.mp4
0124_02_0039.mp4
0018_06_0064.mp4
0022_01_0150.mp4
0061_02_0072.mp4
0017_01_0001.mp4
0133_01_0001.mp4
0006_02_0058.mp4
0137_02_0001.mp4
0174_01_0002.mp4
0069_01_0102.mp4
0175_01_0001.mp4
0100_01_0053.mp4
0019_03_0003.mp4
0161_05_0018.mp4
0150_02_0016.mp4
0086_05_0008.mp4
0092_03_0018.mp4
0021_02_0061.mp4
0183_01_0011.mp4
0071_01_0112.mp4
0170_00_0001.mp4
0084_01_0036.mp4
0145_05_0002.mp4
0061_01_0173.mp4
0068_00_0007.mp4
0059_02_0014.mp4
0003_02_0063.mp4
0072_01_0022.mp4
0150_01_0022.mp4
0010_02_0166.mp4
0065_02_0033.mp4
0015_01_0297.mp4
0075_02_0007.mp4
0031_05_0001.mp4
0040_01_0017.mp4
0168_02_0013.mp4
0009_01_0003.mp4
0018_06_0017.mp4
0076_04_0003.mp4
0097_01_0007.mp4
0156_03_0004.mp4
0110_05_0014.mp4
0175_01_0003.mp4
0178_01_0012.mp4
0061_04_0010.mp4
0064_04_0006.mp4
0019_06_0051.mp4
0061_03_0011.mp4
0165_03_0011.mp4
0091_03_0019.mp4
0088_02_0006.mp4
0061_03_0017.mp4
0053_02_0004.mp4
0044_01_0013.mp4
0074_02_0020.mp4
0089_02_0004.mp4
0078_02_0057.mp4
0112_04_0003.mp4
0086_02_0047.mp4
0026_01_0020.mp4
0083_02_0002.mp4
0074_02_0018.mp4
0016_00_0024.mp4
0015_03_0007.mp4
0072_01_0032.mp4
0071_01_0032.mp4
0048_02_0030.mp4
0139_06_0004.mp4
0052_01_0293.mp4
0112_01_0001.mp4
0074_01_0014.mp4
0165_01_0006.mp4
0098_01_0008.mp4
0121_01_0011.mp4
0022_01_0204.mp4
0106_06_0002.mp4
0006_03_0024.mp4
0017_03_0001.mp4
0015_01_0311.mp4
0004_02_0011.mp4
0048_02_0035.mp4
0104_06_0016.mp4
0187_01_0005.mp4
0163_03_0001.mp4
0016_01_0126.mp4
0015_01_0268.mp4
0036_01_0027.mp4
0030_02_0095.mp4
0095_03_0004.mp4
0005_01_0099.mp4
0107_02_0037.mp4
0078_02_0059.mp4
0060_01_0021.mp4
0041_01_0035.mp4
0039_02_0035.mp4
0175_01_0014.mp4
0047_02_0075.mp4
0150_02_0015.mp4
0051_01_0137.mp4
0149_01_0007.mp4
0066_02_0005.mp4
0116_03_0007.mp4
0069_01_0124.mp4
0010_01_0086.mp4
0081_02_0061.mp4
0110_02_0007.mp4
0049_03_0096.mp4
0006_01_0101.mp4
0124_02_0018.mp4
0134_05_0006.mp4
0005_03_0011.mp4
0141_01_0007.mp4
0010_02_0005.mp4
0059_01_0044.mp4
0061_01_0073.mp4
0066_05_0004.mp4
0105_02_0020.mp4
0027_02_0045.mp4
0081_02_0014.mp4
0097_03_0009.mp4
0006_06_0016.mp4
0055_01_0014.mp4
0019_03_0025.mp4
0003_01_0069.mp4
0124_03_0011.mp4
0182_05_0014.mp4
0019_03_0032.mp4
0126_06_0002.mp4
0064_01_0139.mp4
0163_02_0015.mp4
0017_01_0116.mp4
0020_03_0048.mp4
0051_01_0025.mp4
0016_00_0088.mp4
0139_02_0004.mp4
0008_01_0207.mp4
0018_01_0014.mp4
0032_01_0065.mp4
0082_01_0043.mp4
0060_01_0056.mp4
0082_04_0002.mp4
0121_00_0005.mp4
0119_06_0021.mp4
0019_01_0051.mp4
0103_01_0064.mp4
0006_03_0061.mp4
0025_02_0007.mp4
0163_01_0001.mp4
0081_05_0023.mp4
0048_02_0069.mp4
0020_01_0129.mp4
0153_06_0003.mp4
0008_01_0034.mp4
0013_02_0013.mp4
0004_03_0027.mp4
0004_03_0028.mp4
0019_02_0041.mp4
0193_02_0006.mp4
0136_02_0027.mp4
0017_05_0007.mp4
0008_01_0060.mp4
0012_01_0004.mp4
0052_01_0172.mp4
0102_01_0047.mp4
0120_03_0028.mp4
0101_03_0008.mp4
0184_05_0011.mp4
0052_05_0032.mp4
0071_01_0097.mp4
0072_00_0027.mp4
0182_05_0002.mp4
0016_06_0017.mp4
0048_02_0020.mp4
0036_02_0055.mp4
0154_01_0014.mp4
0071_01_0118.mp4
0051_02_0009.mp4
0062_02_0002.mp4
0173_02_0012.mp4
0021_06_0003.mp4
0150_01_0012.mp4
0180_01_0001.mp4
0017_01_0005.mp4
0068_01_0013.mp4
0088_02_0007.mp4
0075_02_0085.mp4
0096_02_0011.mp4
0035_06_0032.mp4
0097_06_0022.mp4
0173_02_0010.mp4
0186_03_0008.mp4
0096_01_0066.mp4
0004_02_0003.mp4
0013_03_0021.mp4
0034_02_0005.mp4
0004_01_0102.mp4
0010_01_0098.mp4
0012_04_0002.mp4
0020_01_0010.mp4
0018_06_0008.mp4
0004_01_0091.mp4
0036_00_0001.mp4
0035_06_0024.mp4
0022_01_0169.mp4
0020_00_0002.mp4
0035_05_0024.mp4
0138_02_0020.mp4
0187_02_0008.mp4
0096_01_0034.mp4
0111_02_0006.mp4
0026_02_0007.mp4
0061_01_0082.mp4
0069_03_0002.mp4
0011_00_0020.mp4
0057_01_0026.mp4
0096_01_0012.mp4
0040_01_0009.mp4
0021_02_0013.mp4
0064_01_0077.mp4
0030_02_0101.mp4
0047_02_0047.mp4
0134_02_0003.mp4
0031_06_0034.mp4
0078_02_0079.mp4
0006_06_0045.mp4
0063_01_0146.mp4
0026_05_0012.mp4
0122_06_0008.mp4
0142_02_0011.mp4
0014_01_0085.mp4
0072_01_0095.mp4
0145_02_0004.mp4
0071_01_0099.mp4
0143_02_0024.mp4
0057_00_0010.mp4
0075_00_0005.mp4
0052_01_0108.mp4
0014_06_0009.mp4
0051_00_0005.mp4
0016_00_0116.mp4
0187_02_0002.mp4
0065_05_0002.mp4
0071_01_0069.mp4
0006_03_0027.mp4
0174_03_0027.mp4
0143_01_0014.mp4
0136_06_0011.mp4
0150_03_0002.mp4
0008_01_0029.mp4
0130_03_0006.mp4
0005_03_0018.mp4
0019_01_0049.mp4
0093_04_0002.mp4
0067_05_0006.mp4
0075_02_0021.mp4
0109_01_0009.mp4
0140_03_0014.mp4
0094_02_0043.mp4
0051_01_0116.mp4
0184_02_0019.mp4
0135_01_0008.mp4
0072_01_0024.mp4
0032_01_0050.mp4
0054_01_0029.mp4
0190_01_0005.mp4
0036_03_0010.mp4
0094_01_0027.mp4
0139_01_0002.mp4
0090_01_0013.mp4
0049_02_0001.mp4
0005_01_0021.mp4
0101_01_0020.mp4
0074_02_0004.mp4
0015_04_0041.mp4
0072_01_0072.mp4
0123_06_0006.mp4
0079_03_0077.mp4
