0082_06_0062.mp4
0170_06_0002.mp4
0032_01_0013.mp4
0021_02_0034.mp4
0016_02_0024.mp4
0063_01_0110.mp4
0016_00_0115.mp4
0178_02_0017.mp4
0028_02_0005.mp4
0145_02_0025.mp4
0085_01_0068.mp4
0009_01_0138.mp4
0116_03_0014.mp4
0083_03_0027.mp4
0082_01_0084.mp4
0039_02_0005.mp4
0063_02_0009.mp4
0039_01_0045.mp4
0022_02_0008.mp4
0016_03_0192.mp4
0042_02_0007.mp4
0052_01_0197.mp4
0027_04_0034.mp4
0036_03_0016.mp4
0016_06_0089.mp4
0167_01_0013.mp4
0051_01_0013.mp4
0066_01_0025.mp4
0086_02_0013.mp4
0185_02_0012.mp4
0158_01_0004.mp4
0020_01_0040.mp4
0047_02_0010.mp4
0006_06_0018.mp4
0052_01_0138.mp4
0075_00_0018.mp4
0047_02_0052.mp4
0142_02_0015.mp4
0014_01_0044.mp4
0096_01_0037.mp4
0079_03_0009.mp4
0052_05_0007.mp4
0030_06_0001.mp4
0038_05_0008.mp4
0121_02_0003.mp4
0119_02_0011.mp4
0097_01_0028.mp4
0019_01_0043.mp4
0022_06_0094.mp4
0178_01_0003.mp4
0111_01_0014.mp4
0069_01_0071.mp4
0164_03_0001.mp4
0116_02_0018.mp4
0007_05_0012.mp4
0006_03_0053.mp4
0190_01_0008.mp4
0048_01_0003.mp4
0142_03_0032.mp4
0149_01_0004.mp4
0068_00_0010.mp4
0030_01_0041.mp4
0063_01_0004.mp4
0025_02_0001.mp4
0030_02_0058.mp4
0019_01_0031.mp4
0192_03_0019.mp4
0077_01_0008.mp4
0003_01_0003.mp4
0137_02_0032.mp4
0016_03_0126.mp4
0026_00_0005.mp4
0005_01_0005.mp4
0063_01_0069.mp4
0108_02_0006.mp4
0164_02_0018.mp4
0016_03_0023.mp4
0145_05_0021.mp4
0047_02_0113.mp4
0112_01_0014.mp4
0004_05_0006.mp4
0015_01_0155.mp4
0075_00_0028.mp4
0048_01_0014.mp4
0091_03_0038.mp4
0095_01_0039.mp4
0003_02_0106.mp4
0036_02_0009.mp4
0045_02_0026.mp4
0078_02_0134.mp4
0014_01_0049.mp4
0169_02_0011.mp4
0055_06_0003.mp4
0156_01_0004.mp4
0048_02_0046.mp4
0122_02_0002.mp4
0058_01_0059.mp4
0030_02_0074.mp4
0028_03_0006.mp4
0079_03_0006.mp4
0081_02_0037.mp4
0007_01_0028.mp4
0027_01_0006.mp4
0076_01_0022.mp4
0017_02_0001.mp4
0006_02_0169.mp4
0182_00_0004.mp4
0085_01_0087.mp4
0057_01_0041.mp4
0041_00_0005.mp4
0075_00_0007.mp4
0175_02_0007.mp4
0164_06_0022.mp4
0097_01_0033.mp4
0028_06_0029.mp4
0013_00_0007.mp4
0006_01_0095.mp4
0126_01_0016.mp4
0064_04_0004.mp4
0146_05_0013.mp4
0051_06_0012.mp4
0022_01_0277.mp4
0094_02_0028.mp4
0078_02_0139.mp4
0016_00_0020.mp4
0185_01_0007.mp4
0013_01_0011.mp4
0179_02_0011.mp4
0088_06_0009.mp4
0067_03_0010.mp4
0010_01_0017.mp4
0124_01_0009.mp4
0075_01_0093.mp4
0130_06_0005.mp4
0079_01_0009.mp4
0107_03_0002.mp4
0020_04_0004.mp4
0106_02_0015.mp4
0042_02_0012.mp4
0052_01_0077.mp4
0052_01_0143.mp4
0027_00_0012.mp4
0014_01_0111.mp4
0042_01_0036.mp4
0052_01_0124.mp4
0103_01_0053.mp4
0106_03_0024.mp4
0015_01_0294.mp4
0085_01_0047.mp4
0063_01_0178.mp4
0019_01_0023.mp4
0058_01_0025.mp4
0026_02_0008.mp4
0052_01_0216.mp4
0102_04_0017.mp4
0050_03_0005.mp4
0017_01_0156.mp4
0017_01_0041.mp4
0054_01_0022.mp4
0172_01_0013.mp4
0103_06_0012.mp4
0012_02_0003.mp4
0008_05_0006.mp4
0148_02_0033.mp4
0145_04_0002.mp4
0161_05_0009.mp4
0064_01_0071.mp4
0015_01_0321.mp4
0076_02_0014.mp4
0027_03_0009.mp4
0081_01_0015.mp4
0085_01_0029.mp4
0009_06_0005.mp4
0085_01_0005.mp4
0053_01_0003.mp4
0180_05_0006.mp4
0003_01_0098.mp4
0142_03_0118.mp4
0017_01_0105.mp4
0031_03_0013.mp4
0051_01_0100.mp4
0156_06_0009.mp4
0019_02_0052.mp4
0138_05_0002.mp4
0122_01_0014.mp4
0118_05_0008.mp4
0178_01_0020.mp4
0069_02_0027.mp4
0148_01_0027.mp4
0008_01_0098.mp4
0162_02_0018.mp4
0109_06_0017.mp4
0054_02_0050.mp4
0088_05_0008.mp4
0028_01_0028.mp4
0076_02_0059.mp4
0016_02_0016.mp4
0079_03_0056.mp4
0080_01_0087.mp4
0064_05_0004.mp4
0005_02_0034.mp4
0027_00_0016.mp4
0032_05_0005.mp4
0076_01_0007.mp4
0035_05_0016.mp4
0089_02_0074.mp4
0063_01_0149.mp4
0189_01_0005.mp4
0051_01_0031.mp4
0057_01_0089.mp4
0010_02_0088.mp4
0154_05_0005.mp4
0139_01_0020.mp4
0008_01_0024.mp4
0118_01_0008.mp4
0079_00_0008.mp4
0049_03_0050.mp4
0189_00_0009.mp4
0119_05_0023.mp4
0058_02_0006.mp4
0177_03_0003.mp4
0074_00_0016.mp4
0008_01_0076.mp4
0057_01_0113.mp4
0169_02_0005.mp4
0106_04_0007.mp4
0089_03_0067.mp4
0047_02_0023.mp4
0075_00_0020.mp4
0142_01_0025.mp4
0004_01_0051.mp4
0009_01_0014.mp4
0082_01_0011.mp4
0028_04_0001.mp4
0027_06_0011.mp4
0148_01_0003.mp4
0006_03_0054.mp4
0054_03_0023.mp4
0055_01_0002.mp4
0102_01_0004.mp4
0078_01_0023.mp4
0064_01_0033.mp4
0013_03_0011.mp4
0017_02_0022.mp4
0100_02_0017.mp4
0163_01_0015.mp4
0146_05_0011.mp4
0122_01_0011.mp4
0146_02_0006.mp4
0164_02_0026.mp4
0111_02_0003.mp4
0152_02_0011.mp4
0091_03_0009.mp4
0013_06_0013.mp4
0157_05_0005.mp4
0040_06_0013.mp4
0071_01_0044.mp4
0038_01_0005.mp4
0016_00_0061.mp4
0086_06_0001.mp4
0019_02_0057.mp4
0174_03_0026.mp4
0154_00_0003.mp4
0060_01_0116.mp4
0123_05_0004.mp4
0057_01_0023.mp4
0031_02_0013.mp4
0069_01_0039.mp4
0014_02_0002.mp4
0017_01_0109.mp4
0088_03_0024.mp4
0187_01_0006.mp4
0011_00_0016.mp4
0052_03_0006.mp4
0005_01_0069.mp4
0047_03_0039.mp4
0059_04_0014.mp4
0010_02_0153.mp4
0013_00_0011.mp4
0054_03_0063.mp4
0052_04_0001.mp4
0010_02_0037.mp4
0005_02_0026.mp4
0128_00_0002.mp4
0004_01_0157.mp4
0143_03_0018.mp4
0161_00_0001.mp4
0136_06_0013.mp4
0077_05_0026.mp4
0071_06_0003.mp4
0093_01_0014.mp4
0041_06_0006.mp4
0134_04_0007.mp4
0193_03_0006.mp4
0072_01_0035.mp4
0071_01_0071.mp4
0188_02_0004.mp4
0128_00_0019.mp4
0154_02_0008.mp4
0087_01_0035.mp4
0071_01_0083.mp4
0193_05_0001.mp4
0057_01_0071.mp4
0026_01_0024.mp4
0012_06_0009.mp4
0074_00_0005.mp4
0011_02_0007.mp4
0015_05_0002.mp4
0019_02_0007.mp4
0061_01_0065.mp4
0139_05_0012.mp4
0100_03_0002.mp4
0016_02_0026.mp4
0013_02_0015.mp4
0036_02_0025.mp4
0010_02_0223.mp4
0047_01_0016.mp4
0003_02_0013.mp4
0076_02_0035.mp4
0042_01_0024.mp4
0043_01_0027.mp4
0108_02_0011.mp4
0025_01_0065.mp4
0031_02_0019.mp4
0047_06_0011.mp4
0016_01_0038.mp4
0097_01_0003.mp4
0188_03_0010.mp4
0169_01_0014.mp4
0094_02_0007.mp4
0076_02_0057.mp4
0054_02_0027.mp4
0026_02_0003.mp4
0027_06_0018.mp4
0078_02_0120.mp4
0027_04_0026.mp4
0094_06_0001.mp4
0140_03_0036.mp4
0051_01_0111.mp4
0106_03_0004.mp4
0087_00_0004.mp4
0080_01_0028.mp4
0076_01_0014.mp4
0048_02_0053.mp4
0065_02_0011.mp4
0162_02_0014.mp4
0022_01_0037.mp4
0061_01_0151.mp4
0072_01_0042.mp4
0075_02_0080.mp4
0038_05_0007.mp4
0040_05_0002.mp4
0085_01_0050.mp4
0026_01_0012.mp4
0048_01_0004.mp4
0082_01_0034.mp4
0062_06_0002.mp4
0005_02_0019.mp4
0016_03_0055.mp4
0162_06_0008.mp4
0104_01_0032.mp4
0187_03_0018.mp4
0016_03_0024.mp4
0154_02_0011.mp4
0090_03_0006.mp4
0005_01_0085.mp4
0174_03_0023.mp4
0183_01_0009.mp4
0011_00_0009.mp4
0070_01_0109.mp4
0052_01_0230.mp4
0052_01_0236.mp4
0014_01_0115.mp4
0012_06_0056.mp4
0037_03_0011.mp4
