0132_01_0015.mp4
0075_02_0045.mp4
0102_05_0001.mp4
0064_02_0010.mp4
0059_02_0037.mp4
0049_03_0009.mp4
0004_03_0093.mp4
0028_05_0012.mp4
0040_03_0003.mp4
0059_03_0018.mp4
0016_03_0120.mp4
0071_01_0082.mp4
0016_03_0217.mp4
0059_01_0091.mp4
0057_01_0094.mp4
0071_01_0019.mp4
0076_01_0027.mp4
0071_01_0037.mp4
0058_02_0008.mp4
0048_02_0016.mp4
0019_01_0001.mp4
0110_04_0001.mp4
0022_01_0238.mp4
0163_00_0010.mp4
0061_02_0066.mp4
0184_02_0008.mp4
0191_02_0038.mp4
0066_01_0022.mp4
0139_02_0035.mp4
0082_01_0050.mp4
0028_05_0006.mp4
0078_01_0010.mp4
0165_01_0002.mp4
0069_01_0108.mp4
0080_01_0021.mp4
0082_02_0011.mp4
0054_04_0002.mp4
0047_02_0074.mp4
0089_03_0066.mp4
0103_02_0005.mp4
0076_02_0125.mp4
0138_01_0011.mp4
0039_01_0057.mp4
0053_02_0018.mp4
0171_01_0023.mp4
0031_02_0007.mp4
0048_00_0010.mp4
0113_02_0003.mp4
0113_02_0013.mp4
0003_02_0032.mp4
0064_02_0017.mp4
0103_02_0013.mp4
0054_01_0032.mp4
0014_00_0001.mp4
0091_01_0036.mp4
0051_01_0070.mp4
0020_03_0081.mp4
0019_06_0012.mp4
0119_03_0002.mp4
0078_03_0007.mp4
0076_01_0041.mp4
0091_05_0004.mp4
0129_02_0010.mp4
0013_02_0019.mp4
0006_02_0063.mp4
0006_02_0019.mp4
0003_01_0018.mp4
0006_02_0005.mp4
0036_02_0017.mp4
0022_01_0139.mp4
0027_02_0047.mp4
0041_01_0015.mp4
0142_01_0012.mp4
0007_01_0060.mp4
0107_02_0016.mp4
0076_02_0135.mp4
0007_01_0097.mp4
0020_01_0103.mp4
0154_01_0004.mp4
0007_01_0080.mp4
0076_01_0011.mp4
0017_01_0135.mp4
0065_06_0006.mp4
0053_02_0011.mp4
0004_01_0058.mp4
0076_02_0117.mp4
0078_01_0084.mp4
0022_01_0200.mp4
0019_06_0019.mp4
0018_02_0002.mp4
0016_03_0111.mp4
0057_01_0103.mp4
0020_01_0022.mp4
0006_02_0101.mp4
0020_01_0088.mp4
0005_01_0006.mp4
0036_03_0005.mp4
0052_01_0089.mp4
0032_06_0001.mp4
0160_01_0002.mp4
0028_02_0022.mp4
0092_01_0020.mp4
0077_02_0005.mp4
0017_01_0050.mp4
0038_00_0014.mp4
0058_02_0012.mp4
0135_00_0007.mp4
0134_01_0015.mp4
0069_01_0040.mp4
0082_01_0009.mp4
0052_01_0153.mp4
0133_05_0011.mp4
0151_00_0004.mp4
0049_02_0024.mp4
0147_01_0003.mp4
0014_03_0009.mp4
0080_01_0038.mp4
0004_05_0016.mp4
0049_02_0007.mp4
0065_02_0025.mp4
0108_01_0003.mp4
0057_01_0062.mp4
0008_01_0193.mp4
0178_03_0014.mp4
0064_06_0008.mp4
0010_02_0025.mp4
0016_03_0058.mp4
0019_03_0007.mp4
0022_02_0001.mp4
0150_01_0015.mp4
0017_01_0085.mp4
0020_06_0037.mp4
0139_02_0044.mp4
0087_02_0031.mp4
0038_05_0001.mp4
0032_01_0048.mp4
0068_01_0003.mp4
0163_01_0025.mp4
0166_01_0021.mp4
0076_01_0031.mp4
0052_01_0200.mp4
0035_06_0005.mp4
0075_01_0045.mp4
0187_03_0056.mp4
0100_01_0009.mp4
0017_01_0096.mp4
0025_01_0062.mp4
0122_02_0018.mp4
0020_01_0025.mp4
0095_02_0032.mp4
0017_01_0184.mp4
0026_02_0040.mp4
0142_02_0004.mp4
0103_01_0009.mp4
0015_01_0192.mp4
0017_02_0007.mp4
0175_02_0006.mp4
0013_02_0029.mp4
0016_01_0059.mp4
0004_01_0015.mp4
0097_05_0008.mp4
0070_01_0120.mp4
0072_00_0015.mp4
0065_01_0016.mp4
0075_02_0068.mp4
0038_06_0008.mp4
0027_04_0006.mp4
0187_02_0010.mp4
0145_02_0026.mp4
0062_01_0026.mp4
0087_03_0016.mp4
0122_01_0003.mp4
0112_00_0004.mp4
0054_03_0065.mp4
0069_02_0003.mp4
0052_01_0093.mp4
0091_00_0002.mp4
0066_05_0002.mp4
0009_01_0063.mp4
0016_03_0027.mp4
0084_01_0013.mp4
0078_01_0093.mp4
0073_01_0004.mp4
0022_01_0108.mp4
0117_06_0001.mp4
0015_01_0087.mp4
0097_06_0016.mp4
0007_01_0087.mp4
0124_01_0019.mp4
0088_02_0026.mp4
0074_01_0015.mp4
0016_00_0004.mp4
0004_03_0003.mp4
0026_02_0002.mp4
0087_03_0046.mp4
0100_01_0043.mp4
0075_01_0018.mp4
0016_01_0136.mp4
0082_01_0019.mp4
0172_03_0009.mp4
0047_00_0024.mp4
0136_02_0002.mp4
0115_01_0020.mp4
0191_02_0025.mp4
0019_06_0057.mp4
0048_02_0025.mp4
0006_06_0098.mp4
0032_02_0023.mp4
0158_02_0005.mp4
0154_05_0004.mp4
0051_01_0106.mp4
0068_00_0004.mp4
0084_01_0039.mp4
0021_02_0005.mp4
0003_02_0008.mp4
0017_06_0003.mp4
0026_01_0014.mp4
0053_04_0001.mp4
0022_01_0286.mp4
0008_01_0100.mp4
0064_01_0003.mp4
0171_01_0015.mp4
0088_03_0003.mp4
0020_01_0118.mp4
0126_02_0021.mp4
0027_02_0017.mp4
0085_02_0042.mp4
0163_01_0019.mp4
0061_02_0013.mp4
0016_03_0138.mp4
0091_03_0035.mp4
0082_04_0005.mp4
0009_02_0003.mp4
0010_02_0071.mp4
0004_03_0057.mp4
0015_01_0146.mp4
0062_02_0023.mp4
0037_05_0012.mp4
0007_01_0037.mp4
0022_06_0057.mp4
0013_01_0020.mp4
0022_02_0020.mp4
0060_01_0080.mp4
0053_01_0007.mp4
0009_01_0094.mp4
0010_03_0006.mp4
0128_06_0001.mp4
0015_01_0139.mp4
0080_01_0140.mp4
0016_03_0043.mp4
0049_02_0027.mp4
0006_03_0052.mp4
0167_02_0004.mp4
0020_01_0021.mp4
0120_03_0061.mp4
0016_01_0103.mp4
0168_01_0018.mp4
0094_03_0013.mp4
0004_03_0083.mp4
0057_02_0030.mp4
0112_04_0004.mp4
0177_01_0007.mp4
0054_05_0001.mp4
0061_01_0070.mp4
0153_05_0002.mp4
0078_02_0007.mp4
0147_00_0002.mp4
0006_01_0027.mp4
0154_02_0024.mp4
0085_01_0094.mp4
0084_01_0053.mp4
0048_02_0085.mp4
0022_02_0022.mp4
0064_02_0007.mp4
0020_01_0012.mp4
0008_01_0110.mp4
0091_03_0043.mp4
0036_02_0021.mp4
0089_02_0010.mp4
0006_01_0099.mp4
0048_03_0006.mp4
0020_01_0111.mp4
0006_04_0008.mp4
0054_03_0038.mp4
0007_06_0005.mp4
0122_02_0014.mp4
0092_01_0004.mp4
0178_05_0016.mp4
0143_05_0007.mp4
0072_01_0074.mp4
0012_01_0019.mp4
0051_01_0164.mp4
0139_02_0042.mp4
0106_01_0002.mp4
0076_04_0011.mp4
0091_01_0045.mp4
0105_03_0003.mp4
0039_01_0067.mp4
0016_00_0027.mp4
0027_01_0031.mp4
0035_01_0018.mp4
0054_05_0033.mp4
0009_01_0129.mp4
0065_01_0022.mp4
0169_02_0006.mp4
0102_06_0022.mp4
0029_02_0017.mp4
0121_00_0004.mp4
0025_01_0005.mp4
0011_02_0009.mp4
0187_02_0003.mp4
0064_01_0156.mp4
0119_05_0021.mp4
0082_02_0012.mp4
0054_06_0002.mp4
0112_00_0003.mp4
0003_02_0044.mp4
0071_01_0101.mp4
0070_01_0024.mp4
0124_02_0024.mp4
0013_01_0015.mp4
0026_00_0004.mp4
0052_01_0139.mp4
0026_06_0003.mp4
0169_03_0009.mp4
0143_05_0005.mp4
0027_02_0033.mp4
0179_02_0013.mp4
0187_02_0007.mp4
0078_02_0145.mp4
0139_01_0013.mp4
0003_01_0047.mp4
0003_01_0020.mp4
0019_02_0015.mp4
0061_01_0088.mp4
0123_02_0008.mp4
0093_01_0045.mp4
0182_06_0007.mp4
0075_01_0108.mp4
0064_01_0149.mp4
0152_01_0003.mp4
0011_02_0003.mp4
0019_06_0022.mp4
0080_01_0161.mp4
0031_02_0010.mp4
0031_06_0016.mp4
0061_05_0022.mp4
0047_03_0043.mp4
0041_05_0007.mp4
0175_01_0005.mp4
0014_01_0087.mp4
0049_03_0073.mp4
0012_06_0044.mp4
0036_06_0008.mp4
0078_01_0040.mp4
0087_03_0071.mp4
0183_00_0003.mp4
0081_01_0034.mp4
0051_01_0091.mp4
0009_01_0008.mp4
0038_05_0006.mp4
0048_02_0052.mp4
0067_03_0008.mp4
0016_01_0021.mp4
0017_01_0052.mp4
0047_02_0111.mp4
0021_02_0016.mp4
0016_00_0112.mp4
0006_06_0065.mp4
0004_01_0064.mp4
0010_03_0013.mp4
0180_03_0005.mp4
0039_02_0047.mp4
0032_01_0002.mp4
0143_03_0001.mp4
