0182_02_0015.mp4
0057_01_0012.mp4
0128_02_0007.mp4
0004_01_0039.mp4
0115_06_0002.mp4
0177_01_0009.mp4
0153_05_0009.mp4
0057_01_0106.mp4
0121_02_0019.mp4
0082_06_0061.mp4
0021_02_0031.mp4
0052_02_0002.mp4
0070_01_0032.mp4
0044_01_0001.mp4
0010_02_0196.mp4
0064_05_0012.mp4
0017_03_0004.mp4
0185_05_0004.mp4
0105_02_0012.mp4
0035_00_0017.mp4
0119_05_0015.mp4
0011_00_0012.mp4
0015_01_0230.mp4
0133_03_0004.mp4
0160_06_0007.mp4
0089_01_0004.mp4
0004_01_0085.mp4
0010_03_0078.mp4
0060_01_0027.mp4
0088_05_0005.mp4
0057_01_0039.mp4
0172_02_0016.mp4
0017_01_0169.mp4
0075_02_0019.mp4
0049_03_0038.mp4
0041_03_0011.mp4
0059_03_0020.mp4
0031_03_0010.mp4
0048_02_0055.mp4
0060_01_0035.mp4
0112_02_0009.mp4
0134_03_0016.mp4
0141_02_0008.mp4
0178_05_0001.mp4
0078_06_0057.mp4
0013_01_0037.mp4
0159_02_0008.mp4
0007_01_0021.mp4
0144_06_0005.mp4
0139_02_0045.mp4
0045_01_0014.mp4
0136_02_0009.mp4
0016_03_0136.mp4
0076_02_0136.mp4
0040_05_0011.mp4
0010_02_0171.mp4
0145_01_0023.mp4
0010_02_0184.mp4
0027_01_0025.mp4
0013_00_0002.mp4
0106_03_0003.mp4
0009_01_0096.mp4
0021_02_0021.mp4
0117_01_0001.mp4
0104_01_0035.mp4
0095_01_0010.mp4
0141_05_0002.mp4
0008_01_0127.mp4
0009_01_0102.mp4
0059_03_0001.mp4
0010_01_0051.mp4
0121_00_0001.mp4
0139_02_0052.mp4
0009_02_0009.mp4
0036_01_0005.mp4
0054_03_0077.mp4
0028_00_0005.mp4
0020_06_0035.mp4
0098_01_0012.mp4
0180_03_0004.mp4
0128_03_0022.mp4
0080_01_0061.mp4
0052_02_0009.mp4
0088_01_0007.mp4
0049_03_0027.mp4
0074_03_0039.mp4
0003_01_0078.mp4
0071_02_0005.mp4
0022_01_0118.mp4
0009_03_0004.mp4
0076_02_0018.mp4
0035_01_0007.mp4
0096_01_0073.mp4
0097_06_0005.mp4
0077_01_0027.mp4
0022_01_0177.mp4
0041_01_0023.mp4
0015_01_0003.mp4
0004_03_0042.mp4
0120_03_0035.mp4
0175_05_0027.mp4
0008_01_0142.mp4
0015_01_0167.mp4
0124_06_0007.mp4
0084_06_0019.mp4
0011_06_0005.mp4
0047_00_0009.mp4
0089_03_0074.mp4
0052_01_0111.mp4
0026_02_0033.mp4
0193_03_0033.mp4
0019_01_0094.mp4
0086_06_0007.mp4
0119_03_0011.mp4
0028_01_0010.mp4
0028_02_0018.mp4
0046_02_0008.mp4
0016_00_0095.mp4
0063_01_0152.mp4
0076_02_0086.mp4
0010_01_0044.mp4
0015_01_0184.mp4
0173_00_0002.mp4
0177_00_0001.mp4
0009_01_0011.mp4
0091_03_0018.mp4
0078_01_0091.mp4
0080_01_0079.mp4
0066_01_0027.mp4
0081_02_0052.mp4
0179_02_0007.mp4
0015_01_0143.mp4
0015_01_0036.mp4
0028_01_0019.mp4
0077_05_0007.mp4
0094_01_0001.mp4
0043_01_0010.mp4
0093_06_0008.mp4
0138_06_0001.mp4
0136_04_0007.mp4
0017_02_0026.mp4
0120_01_0013.mp4
0035_02_0004.mp4
0097_06_0001.mp4
0185_05_0005.mp4
0052_01_0110.mp4
0041_02_0031.mp4
0109_01_0007.mp4
0010_03_0023.mp4
0061_06_0021.mp4
0006_02_0151.mp4
0010_02_0154.mp4
0039_01_0028.mp4
0009_06_0004.mp4
0164_03_0018.mp4
0010_03_0026.mp4
0004_01_0022.mp4
0036_02_0038.mp4
0142_03_0144.mp4
0039_01_0068.mp4
0128_00_0023.mp4
0142_03_0135.mp4
0005_02_0010.mp4
0063_01_0104.mp4
0010_02_0043.mp4
0038_01_0009.mp4
0046_01_0017.mp4
0016_03_0171.mp4
0087_02_0075.mp4
0110_01_0010.mp4
0082_06_0057.mp4
0070_01_0160.mp4
0193_03_0002.mp4
0187_01_0012.mp4
0076_01_0006.mp4
0059_01_0101.mp4
0030_02_0100.mp4
0120_01_0014.mp4
0033_02_0005.mp4
0080_01_0068.mp4
0151_03_0005.mp4
0115_01_0025.mp4
0049_03_0020.mp4
0022_01_0134.mp4
0124_05_0001.mp4
0094_02_0041.mp4
0179_05_0004.mp4
0017_01_0094.mp4
0017_01_0011.mp4
0118_02_0003.mp4
0010_02_0211.mp4
0097_06_0017.mp4
0013_06_0022.mp4
0012_06_0011.mp4
0135_04_0001.mp4
0042_01_0021.mp4
0009_01_0131.mp4
0041_06_0008.mp4
0058_02_0009.mp4
0069_01_0026.mp4
0016_01_0051.mp4
0005_01_0060.mp4
0100_01_0025.mp4
0061_01_0148.mp4
0147_01_0006.mp4
0003_01_0023.mp4
0116_03_0015.mp4
0120_01_0019.mp4
0022_01_0026.mp4
0070_02_0001.mp4
0190_02_0004.mp4
0030_02_0030.mp4
0152_02_0010.mp4
0189_02_0005.mp4
0168_05_0001.mp4
0055_01_0006.mp4
0162_02_0003.mp4
0015_06_0008.mp4
0106_02_0021.mp4
0025_03_0033.mp4
0103_02_0048.mp4
0049_01_0017.mp4
0003_02_0011.mp4
0087_03_0103.mp4
0021_02_0048.mp4
0082_01_0065.mp4
0054_02_0018.mp4
0016_01_0042.mp4
0063_01_0175.mp4
0169_06_0002.mp4
0049_03_0100.mp4
0119_04_0016.mp4
0016_02_0010.mp4
0004_01_0166.mp4
0127_02_0001.mp4
0047_02_0006.mp4
0116_01_0004.mp4
0092_00_0001.mp4
0145_03_0003.mp4
0072_01_0016.mp4
0072_03_0007.mp4
0010_02_0022.mp4
0145_04_0004.mp4
0080_01_0023.mp4
0021_02_0115.mp4
0163_01_0018.mp4
0020_03_0080.mp4
0016_00_0104.mp4
0008_01_0043.mp4
0014_02_0029.mp4
0101_05_0003.mp4
0107_00_0036.mp4
0019_01_0044.mp4
0036_02_0001.mp4
0069_00_0006.mp4
0076_01_0017.mp4
0141_02_0002.mp4
0081_01_0038.mp4
0141_06_0010.mp4
0048_05_0001.mp4
0120_01_0006.mp4
0133_00_0007.mp4
0045_02_0010.mp4
0019_01_0078.mp4
0049_03_0010.mp4
0019_04_0001.mp4
0089_01_0022.mp4
0171_01_0001.mp4
0075_02_0017.mp4
0103_01_0065.mp4
0178_01_0014.mp4
0034_01_0002.mp4
0059_04_0005.mp4
0135_03_0014.mp4
0032_06_0014.mp4
0010_02_0123.mp4
0050_02_0003.mp4
0076_02_0026.mp4
0059_05_0023.mp4
0006_02_0171.mp4
0039_01_0030.mp4
0009_01_0068.mp4
0061_01_0152.mp4
0036_02_0016.mp4
0129_02_0015.mp4
0169_02_0008.mp4
0051_01_0042.mp4
0071_03_0003.mp4
0089_03_0051.mp4
0022_01_0073.mp4
0044_01_0016.mp4
0118_04_0005.mp4
0022_03_0016.mp4
0166_02_0015.mp4
0152_03_0007.mp4
0010_03_0042.mp4
0174_02_0016.mp4
0050_00_0003.mp4
0186_02_0014.mp4
0032_02_0035.mp4
0066_02_0024.mp4
0070_01_0056.mp4
0022_01_0052.mp4
0069_01_0086.mp4
0166_04_0006.mp4
0087_03_0082.mp4
0052_01_0091.mp4
0071_05_0003.mp4
0015_01_0264.mp4
0040_00_0005.mp4
0012_06_0063.mp4
0053_01_0024.mp4
0038_06_0016.mp4
0180_02_0013.mp4
0008_01_0002.mp4
0010_02_0224.mp4
0028_03_0010.mp4
0139_01_0021.mp4
0068_06_0004.mp4
0158_05_0004.mp4
0163_04_0002.mp4
0054_02_0004.mp4
0126_03_0009.mp4
0012_06_0012.mp4
0071_01_0105.mp4
0016_06_0081.mp4
0119_03_0010.mp4
0089_01_0040.mp4
0007_02_0004.mp4
0049_03_0002.mp4
0150_02_0002.mp4
0064_01_0073.mp4
0067_05_0004.mp4
0015_01_0136.mp4
0071_03_0028.mp4
0014_06_0008.mp4
0015_01_0309.mp4
0063_01_0054.mp4
0035_05_0002.mp4
0021_01_0019.mp4
0052_01_0088.mp4
0063_01_0176.mp4
0080_01_0050.mp4
0021_02_0101.mp4
0003_05_0002.mp4
0052_01_0099.mp4
0143_01_0012.mp4
0087_00_0007.mp4
0036_02_0044.mp4
0079_01_0007.mp4
0122_02_0008.mp4
0175_01_0006.mp4
0030_02_0029.mp4
0133_00_0003.mp4
0006_01_0108.mp4
0148_03_0004.mp4
0105_01_0018.mp4
0039_06_0001.mp4
0036_01_0040.mp4
0015_01_0019.mp4
0006_02_0104.mp4
0006_02_0160.mp4
0080_01_0011.mp4
0143_02_0026.mp4
0014_01_0027.mp4
0122_06_0002.mp4
0189_01_0017.mp4
0015_01_0316.mp4
0019_01_0077.mp4
0037_05_0006.mp4
0044_02_0008.mp4
0051_06_0007.mp4
0006_01_0063.mp4
0016_01_0035.mp4
0169_01_0007.mp4
