0010_03_0009.mp4
0047_03_0073.mp4
0013_02_0020.mp4
0064_01_0011.mp4
0143_06_0006.mp4
0016_03_0119.mp4
0061_06_0054.mp4
0139_06_0006.mp4
0164_05_0003.mp4
0026_01_0052.mp4
0030_02_0012.mp4
0132_01_0014.mp4
0047_02_0112.mp4
0135_00_0015.mp4
0039_05_0007.mp4
0110_03_0003.mp4
0019_06_0085.mp4
0069_02_0007.mp4
0102_01_0038.mp4
0080_01_0129.mp4
0030_00_0006.mp4
0026_02_0010.mp4
0089_01_0037.mp4
0061_02_0063.mp4
0041_01_0002.mp4
0051_01_0039.mp4
0051_01_0098.mp4
0080_01_0116.mp4
0052_01_0019.mp4
0005_01_0013.mp4
0015_06_0005.mp4
0123_03_0001.mp4
0031_01_0007.mp4
0136_02_0003.mp4
0053_06_0006.mp4
0004_03_0069.mp4
0060_01_0004.mp4
0047_02_0064.mp4
0104_01_0040.mp4
0006_06_0068.mp4
0069_01_0046.mp4
0178_05_0006.mp4
0136_02_0022.mp4
0079_01_0017.mp4
0140_03_0025.mp4
0142_03_0138.mp4
0051_01_0024.mp4
0159_01_0022.mp4
0107_03_0001.mp4
0169_03_0006.mp4
0057_01_0132.mp4
0083_02_0006.mp4
0014_01_0062.mp4
0009_01_0019.mp4
0052_01_0020.mp4
0043_01_0029.mp4
0082_01_0026.mp4
0074_03_0030.mp4
0120_05_0007.mp4
0120_03_0063.mp4
0042_00_0012.mp4
0177_01_0014.mp4
0148_03_0002.mp4
0147_02_0005.mp4
0083_03_0024.mp4
0025_05_0012.mp4
0190_03_0006.mp4
0036_01_0016.mp4
0061_01_0006.mp4
0070_01_0041.mp4
0066_05_0007.mp4
0016_01_0020.mp4
0016_06_0008.mp4
0021_01_0065.mp4
0003_01_0084.mp4
0080_01_0012.mp4
0035_02_0002.mp4
0086_04_0002.mp4
0026_01_0062.mp4
0170_02_0006.mp4
0140_00_0006.mp4
0012_01_0003.mp4
0122_01_0007.mp4
0097_01_0022.mp4
0171_01_0003.mp4
0142_03_0124.mp4
0121_03_0018.mp4
0022_01_0104.mp4
0038_01_0029.mp4
0043_01_0007.mp4
0190_01_0003.mp4
0074_01_0004.mp4
0006_04_0004.mp4
0059_01_0037.mp4
0178_05_0002.mp4
0008_01_0125.mp4
0118_00_0011.mp4
0170_05_0003.mp4
0063_01_0026.mp4
0010_02_0047.mp4
0178_05_0009.mp4
0076_02_0124.mp4
0161_05_0026.mp4
0053_04_0015.mp4
0069_01_0022.mp4
0015_01_0191.mp4
0138_02_0006.mp4
0135_06_0013.mp4
0006_03_0030.mp4
0078_01_0126.mp4
0019_06_0083.mp4
0138_03_0002.mp4
0087_03_0013.mp4
0094_02_0018.mp4
0039_02_0016.mp4
0156_02_0003.mp4
0006_01_0128.mp4
0052_01_0255.mp4
0063_01_0023.mp4
0014_02_0023.mp4
0009_01_0104.mp4
0155_02_0004.mp4
0082_01_0064.mp4
0119_00_0003.mp4
0016_01_0004.mp4
0014_03_0002.mp4
0073_01_0016.mp4
0096_02_0032.mp4
0171_03_0006.mp4
0130_01_0006.mp4
0032_01_0021.mp4
0144_03_0006.mp4
0092_05_0006.mp4
0069_01_0024.mp4
0112_00_0008.mp4
0070_02_0011.mp4
0015_04_0037.mp4
0172_01_0011.mp4
0115_02_0023.mp4
0051_01_0171.mp4
0050_06_0016.mp4
0109_00_0012.mp4
0055_01_0003.mp4
0095_03_0017.mp4
0003_01_0086.mp4
0005_02_0002.mp4
0075_02_0072.mp4
0010_03_0021.mp4
0052_01_0081.mp4
0075_01_0065.mp4
0003_02_0112.mp4
0079_02_0024.mp4
0061_01_0139.mp4
0089_00_0005.mp4
0063_01_0123.mp4
0164_03_0004.mp4
0145_02_0003.mp4
0128_00_0011.mp4
0020_01_0050.mp4
0124_02_0026.mp4
0112_00_0019.mp4
0070_01_0159.mp4
0089_03_0018.mp4
0156_04_0001.mp4
0049_03_0099.mp4
0012_04_0001.mp4
0178_00_0006.mp4
0004_03_0065.mp4
0061_06_0020.mp4
0030_01_0040.mp4
0080_01_0009.mp4
0078_01_0037.mp4
0174_03_0001.mp4
0007_01_0141.mp4
0057_01_0131.mp4
0020_03_0010.mp4
0064_01_0040.mp4
0019_06_0072.mp4
0008_03_0001.mp4
0189_06_0007.mp4
0025_03_0038.mp4
0089_03_0065.mp4
0096_01_0093.mp4
0120_05_0005.mp4
0054_01_0024.mp4
0070_01_0144.mp4
0077_01_0025.mp4
0059_01_0017.mp4
0166_03_0008.mp4
0076_04_0001.mp4
0003_01_0103.mp4
0147_02_0014.mp4
0126_01_0003.mp4
0098_03_0002.mp4
0029_00_0002.mp4
0104_01_0003.mp4
0107_06_0006.mp4
0035_06_0009.mp4
0031_00_0005.mp4
0059_05_0011.mp4
0038_01_0039.mp4
0174_03_0006.mp4
0031_02_0051.mp4
0080_01_0154.mp4
0146_01_0002.mp4
0052_05_0008.mp4
0006_05_0003.mp4
0139_02_0024.mp4
0151_06_0018.mp4
0014_01_0102.mp4
0186_06_0001.mp4
0006_06_0041.mp4
0007_02_0012.mp4
0169_03_0002.mp4
0090_01_0017.mp4
0092_05_0005.mp4
0039_01_0050.mp4
0185_00_0008.mp4
0119_05_0003.mp4
0134_05_0010.mp4
0187_03_0112.mp4
0180_02_0017.mp4
0163_00_0005.mp4
0036_01_0002.mp4
0166_05_0004.mp4
0065_01_0038.mp4
0112_02_0013.mp4
0144_01_0011.mp4
0096_06_0013.mp4
0152_01_0011.mp4
0064_01_0029.mp4
0175_05_0029.mp4
0059_04_0011.mp4
0177_01_0001.mp4
0015_04_0049.mp4
0152_06_0001.mp4
0059_02_0034.mp4
0187_04_0001.mp4
0049_03_0097.mp4
0051_01_0014.mp4
0013_03_0006.mp4
0008_01_0074.mp4
0134_04_0002.mp4
0080_01_0015.mp4
0021_02_0119.mp4
0015_01_0119.mp4
0082_01_0030.mp4
0020_01_0081.mp4
0096_02_0017.mp4
0043_01_0025.mp4
0072_01_0057.mp4
0047_02_0086.mp4
0047_03_0075.mp4
0027_03_0004.mp4
0047_06_0016.mp4
0112_04_0005.mp4
0108_00_0012.mp4
0190_04_0002.mp4
0170_00_0005.mp4
0017_01_0090.mp4
0160_01_0013.mp4
0009_01_0092.mp4
0133_02_0016.mp4
0021_03_0005.mp4
0063_05_0009.mp4
0102_06_0024.mp4
0016_03_0199.mp4
0059_01_0060.mp4
0089_02_0049.mp4
0061_01_0032.mp4
0104_03_0005.mp4
0037_01_0020.mp4
0022_06_0068.mp4
0062_06_0010.mp4
0137_03_0002.mp4
0082_01_0014.mp4
0061_01_0164.mp4
0111_01_0007.mp4
0052_01_0170.mp4
0041_02_0015.mp4
0183_00_0001.mp4
0076_06_0002.mp4
0071_01_0031.mp4
0126_04_0006.mp4
0020_01_0026.mp4
0087_02_0099.mp4
0087_03_0075.mp4
0164_02_0021.mp4
0078_01_0045.mp4
0170_00_0004.mp4
0016_01_0013.mp4
0025_01_0007.mp4
0094_01_0017.mp4
0076_02_0053.mp4
0105_02_0001.mp4
0051_01_0093.mp4
0032_01_0070.mp4
0077_05_0034.mp4
0047_02_0034.mp4
0006_03_0044.mp4
0136_03_0018.mp4
0014_03_0001.mp4
0151_05_0002.mp4
0190_06_0005.mp4
0021_02_0078.mp4
0066_01_0013.mp4
0103_01_0013.mp4
0025_04_0010.mp4
0094_03_0012.mp4
0086_02_0001.mp4
0044_05_0005.mp4
0020_03_0009.mp4
0165_03_0020.mp4
0058_02_0014.mp4
0133_01_0005.mp4
0006_01_0078.mp4
0189_01_0020.mp4
0089_03_0024.mp4
0137_00_0008.mp4
0005_01_0080.mp4
0012_02_0009.mp4
0169_01_0019.mp4
0040_02_0001.mp4
0022_01_0137.mp4
0151_05_0017.mp4
0100_02_0001.mp4
0091_03_0047.mp4
0074_05_0011.mp4
0010_02_0082.mp4
0017_02_0017.mp4
0052_01_0105.mp4
0193_05_0003.mp4
0187_02_0006.mp4
0005_01_0087.mp4
0130_03_0015.mp4
0164_02_0022.mp4
0047_03_0064.mp4
0141_00_0006.mp4
0114_03_0002.mp4
0116_01_0013.mp4
0006_06_0055.mp4
0063_05_0011.mp4
0090_01_0008.mp4
0038_01_0001.mp4
0102_06_0015.mp4
0015_01_0137.mp4
0069_01_0010.mp4
0015_01_0178.mp4
0095_01_0033.mp4
0192_01_0014.mp4
0097_02_0035.mp4
0168_03_0010.mp4
0071_01_0065.mp4
0100_02_0005.mp4
0061_01_0135.mp4
0142_00_0006.mp4
0082_02_0029.mp4
0060_01_0055.mp4
0088_02_0011.mp4
0083_03_0012.mp4
0144_02_0021.mp4
0015_01_0285.mp4
0017_01_0009.mp4
0142_05_0001.mp4
0193_01_0014.mp4
0110_05_0013.mp4
0052_01_0026.mp4
0128_03_0007.mp4
0064_01_0026.mp4
0032_01_0081.mp4
0087_01_0022.mp4
0128_05_0005.mp4
0006_01_0005.mp4
0112_00_0010.mp4
0064_01_0171.mp4
