0070_06_0015.mp4
0105_02_0005.mp4
0178_02_0025.mp4
0040_02_0020.mp4
0068_01_0017.mp4
0004_01_0170.mp4
0021_02_0027.mp4
0049_03_0028.mp4
0054_01_0003.mp4
0019_06_0017.mp4
0168_01_0013.mp4
0147_00_0005.mp4
0040_01_0003.mp4
0052_04_0019.mp4
0027_02_0019.mp4
0178_06_0008.mp4
0016_06_0026.mp4
0078_02_0067.mp4
0016_03_0116.mp4
0081_01_0053.mp4
0070_00_0009.mp4
0046_01_0009.mp4
0138_01_0012.mp4
0187_01_0016.mp4
0048_03_0023.mp4
0120_02_0003.mp4
0192_00_0003.mp4
0039_02_0021.mp4
0139_02_0028.mp4
0146_02_0005.mp4
0069_01_0044.mp4
0156_06_0004.mp4
0150_01_0013.mp4
0102_04_0007.mp4
0068_02_0008.mp4
0084_06_0003.mp4
0010_02_0172.mp4
0076_03_0002.mp4
0140_03_0037.mp4
0103_02_0020.mp4
0108_06_0002.mp4
0159_01_0005.mp4
0014_01_0045.mp4
0052_01_0181.mp4
0019_02_0018.mp4
0102_04_0001.mp4
0078_02_0006.mp4
0027_02_0023.mp4
0006_04_0005.mp4
0054_01_0015.mp4
0147_01_0009.mp4
0007_01_0134.mp4
0092_02_0018.mp4
0064_01_0114.mp4
0014_06_0011.mp4
0157_06_0002.mp4
0006_06_0080.mp4
0072_01_0079.mp4
0111_01_0016.mp4
0066_03_0001.mp4
0013_06_0004.mp4
0170_03_0006.mp4
0172_06_0004.mp4
0052_01_0205.mp4
0058_01_0052.mp4
0062_02_0030.mp4
0062_01_0010.mp4
0016_03_0114.mp4
0078_02_0029.mp4
0070_06_0024.mp4
0138_02_0004.mp4
0082_06_0031.mp4
0010_03_0051.mp4
0186_02_0001.mp4
0077_05_0004.mp4
0059_05_0003.mp4
0178_05_0014.mp4
0013_02_0005.mp4
0003_02_0074.mp4
0026_01_0019.mp4
0142_03_0102.mp4
0081_02_0045.mp4
0153_01_0008.mp4
0020_03_0073.mp4
0170_06_0001.mp4
0175_05_0015.mp4
0007_01_0007.mp4
0007_01_0104.mp4
0004_01_0134.mp4
0089_02_0079.mp4
0043_01_0017.mp4
0010_02_0067.mp4
0015_01_0258.mp4
0178_04_0002.mp4
0085_01_0082.mp4
0061_03_0013.mp4
0045_01_0005.mp4
0009_01_0051.mp4
0110_01_0019.mp4
0016_03_0081.mp4
0049_02_0017.mp4
0047_03_0062.mp4
0109_03_0010.mp4
0047_02_0084.mp4
0153_01_0020.mp4
0178_01_0021.mp4
0161_00_0009.mp4
0099_04_0001.mp4
0073_01_0005.mp4
0164_03_0009.mp4
0165_05_0001.mp4
0178_03_0027.mp4
0020_03_0003.mp4
0047_02_0060.mp4
0040_05_0014.mp4
0159_01_0019.mp4
0008_01_0195.mp4
0189_02_0007.mp4
0078_06_0016.mp4
0157_02_0007.mp4
0064_01_0008.mp4
0020_06_0021.mp4
0013_02_0025.mp4
0184_05_0004.mp4
0020_01_0093.mp4
0077_05_0028.mp4
0031_03_0020.mp4
0065_02_0013.mp4
0076_02_0003.mp4
0006_03_0019.mp4
0119_04_0014.mp4
0069_01_0095.mp4
0010_02_0012.mp4
0048_01_0013.mp4
0140_02_0013.mp4
0010_01_0010.mp4
0031_02_0014.mp4
0139_02_0036.mp4
0031_02_0045.mp4
0070_01_0033.mp4
0069_01_0023.mp4
0021_01_0033.mp4
0038_02_0002.mp4
0075_02_0010.mp4
0081_01_0023.mp4
0182_00_0007.mp4
0170_02_0007.mp4
0022_02_0019.mp4
0168_03_0013.mp4
0029_02_0014.mp4
0180_02_0002.mp4
0076_02_0039.mp4
0019_02_0030.mp4
0075_02_0001.mp4
0022_01_0059.mp4
0178_02_0010.mp4
0022_02_0009.mp4
0128_02_0030.mp4
0021_01_0036.mp4
0020_01_0019.mp4
0059_02_0011.mp4
0052_05_0038.mp4
0064_01_0070.mp4
0047_03_0074.mp4
0030_01_0030.mp4
0026_01_0021.mp4
0110_05_0018.mp4
0089_02_0073.mp4
0022_01_0262.mp4
0058_01_0002.mp4
0113_01_0014.mp4
0090_01_0012.mp4
0098_01_0019.mp4
0004_01_0132.mp4
0006_01_0079.mp4
0006_01_0106.mp4
0177_02_0001.mp4
0142_01_0014.mp4
0078_02_0005.mp4
0004_02_0008.mp4
0078_02_0049.mp4
0160_01_0011.mp4
0063_01_0163.mp4
0004_01_0171.mp4
0092_02_0006.mp4
0170_01_0004.mp4
0028_03_0009.mp4
0139_02_0039.mp4
0009_01_0069.mp4
0054_00_0032.mp4
0060_01_0073.mp4
0034_00_0003.mp4
0016_00_0037.mp4
0041_04_0001.mp4
0017_01_0121.mp4
0004_01_0042.mp4
0070_01_0131.mp4
0142_00_0004.mp4
0007_01_0017.mp4
0064_01_0027.mp4
0061_01_0018.mp4
0098_01_0016.mp4
0061_02_0010.mp4
0004_01_0172.mp4
0047_02_0072.mp4
0020_01_0032.mp4
0012_00_0001.mp4
0116_01_0012.mp4
0015_04_0006.mp4
0112_02_0011.mp4
0174_02_0012.mp4
0067_03_0027.mp4
0089_00_0009.mp4
0007_01_0142.mp4
0094_01_0031.mp4
0016_03_0158.mp4
0068_01_0020.mp4
0010_03_0018.mp4
0035_03_0011.mp4
0046_02_0007.mp4
0047_02_0102.mp4
0133_00_0012.mp4
0080_01_0138.mp4
0022_01_0209.mp4
0049_01_0007.mp4
0076_02_0103.mp4
0016_03_0057.mp4
0187_01_0007.mp4
0009_01_0038.mp4
0017_01_0049.mp4
0047_02_0070.mp4
0064_00_0006.mp4
0031_02_0035.mp4
0061_06_0029.mp4
0008_01_0075.mp4
0161_05_0022.mp4
0103_01_0022.mp4
0113_02_0005.mp4
0021_05_0003.mp4
0046_01_0013.mp4
0032_01_0076.mp4
0074_02_0029.mp4
0019_06_0077.mp4
0016_03_0092.mp4
0034_03_0002.mp4
0022_01_0063.mp4
0054_00_0001.mp4
0138_01_0007.mp4
0109_06_0002.mp4
0079_06_0006.mp4
0004_03_0054.mp4
0078_01_0057.mp4
0016_03_0201.mp4
0136_02_0025.mp4
0064_02_0022.mp4
0092_03_0012.mp4
0022_06_0021.mp4
0051_01_0055.mp4
0010_03_0083.mp4
0069_01_0094.mp4
0057_01_0092.mp4
0142_03_0081.mp4
0101_01_0009.mp4
0177_06_0008.mp4
0071_01_0034.mp4
0190_05_0005.mp4
0136_00_0001.mp4
0085_02_0036.mp4
0008_01_0133.mp4
0062_02_0029.mp4
0016_01_0069.mp4
0118_02_0009.mp4
0193_00_0009.mp4
0027_04_0031.mp4
0137_03_0020.mp4
0006_06_0082.mp4
0007_01_0084.mp4
0119_02_0004.mp4
0003_02_0109.mp4
0072_01_0039.mp4
0039_02_0029.mp4
0020_03_0033.mp4
0052_06_0015.mp4
0102_01_0031.mp4
0096_01_0023.mp4
0108_01_0009.mp4
0096_01_0068.mp4
0103_01_0033.mp4
0071_01_0057.mp4
0016_03_0144.mp4
0088_01_0006.mp4
0103_04_0004.mp4
0008_01_0040.mp4
0131_01_0001.mp4
0070_01_0116.mp4
0057_02_0014.mp4
0120_05_0006.mp4
0066_01_0006.mp4
0006_02_0147.mp4
0078_03_0012.mp4
0088_02_0019.mp4
0070_01_0134.mp4
0059_01_0009.mp4
0032_02_0017.mp4
0016_03_0193.mp4
0015_01_0269.mp4
0069_01_0007.mp4
0049_03_0018.mp4
0035_03_0004.mp4
0063_02_0011.mp4
0180_02_0010.mp4
0029_01_0031.mp4
0092_01_0006.mp4
0100_01_0010.mp4
0027_06_0008.mp4
0022_01_0057.mp4
0134_01_0004.mp4
0058_01_0026.mp4
0174_03_0004.mp4
0026_01_0030.mp4
0059_01_0019.mp4
0008_01_0030.mp4
0149_00_0003.mp4
0165_03_0016.mp4
0016_01_0070.mp4
0035_05_0032.mp4
0075_01_0088.mp4
0011_00_0046.mp4
0039_02_0034.mp4
0144_05_0006.mp4
0004_01_0162.mp4
0145_03_0020.mp4
0099_01_0002.mp4
0007_05_0005.mp4
0036_02_0036.mp4
0027_03_0001.mp4
0057_01_0052.mp4
0033_01_0006.mp4
0005_01_0090.mp4
0164_03_0002.mp4
0136_03_0048.mp4
0086_01_0006.mp4
0016_03_0033.mp4
0157_01_0005.mp4
0129_01_0011.mp4
0027_01_0005.mp4
0075_01_0027.mp4
0102_01_0048.mp4
0052_01_0137.mp4
0152_01_0009.mp4
0127_01_0009.mp4
0097_02_0013.mp4
0030_05_0006.mp4
0169_02_0010.mp4
0124_05_0012.mp4
0010_01_0083.mp4
0018_06_0054.mp4
0027_06_0007.mp4
0079_03_0013.mp4
0151_02_0009.mp4
0100_03_0007.mp4
0005_01_0075.mp4
0109_02_0021.mp4
0110_02_0003.mp4
0063_04_0002.mp4
0087_03_0047.mp4
0017_01_0181.mp4
0151_04_0002.mp4
0099_06_0005.mp4
0006_06_0096.mp4
0009_01_0072.mp4
0028_06_0020.mp4
0164_01_0015.mp4
0144_02_0005.mp4
0191_05_0005.mp4
