0144_01_0013.mp4
0082_02_0002.mp4
0091_01_0007.mp4
0097_01_0016.mp4
0119_06_0006.mp4
0156_03_0010.mp4
0051_01_0047.mp4
0112_00_0013.mp4
0025_01_0057.mp4
0082_01_0089.mp4
0020_03_0082.mp4
0089_01_0051.mp4
0166_04_0001.mp4
0069_00_0013.mp4
0082_01_0029.mp4
0015_04_0053.mp4
0100_02_0008.mp4
0079_02_0004.mp4
0004_02_0009.mp4
0063_05_0008.mp4
0105_02_0014.mp4
0010_02_0204.mp4
0070_01_0069.mp4
0081_01_0037.mp4
0118_02_0008.mp4
0064_01_0196.mp4
0007_01_0056.mp4
0135_00_0006.mp4
0016_03_0174.mp4
0148_01_0009.mp4
0057_01_0087.mp4
0015_01_0296.mp4
0043_00_0001.mp4
0163_01_0008.mp4
0144_01_0003.mp4
0012_00_0003.mp4
0030_02_0011.mp4
0075_02_0048.mp4
0071_01_0005.mp4
0138_03_0010.mp4
0059_01_0107.mp4
0006_01_0083.mp4
0139_02_0038.mp4
0179_04_0006.mp4
0059_01_0073.mp4
0022_01_0089.mp4
0189_06_0004.mp4
0151_05_0011.mp4
0151_02_0011.mp4
0022_01_0240.mp4
0070_01_0011.mp4
0047_03_0030.mp4
0091_01_0012.mp4
0036_01_0013.mp4
0134_01_0006.mp4
0016_02_0008.mp4
0094_01_0018.mp4
0017_01_0030.mp4
0041_03_0005.mp4
0020_03_0063.mp4
0160_06_0010.mp4
0005_01_0089.mp4
0030_02_0046.mp4
0045_03_0005.mp4
0006_02_0142.mp4
0007_01_0033.mp4
0010_02_0190.mp4
0038_00_0032.mp4
0064_06_0011.mp4
0008_01_0180.mp4
0189_01_0008.mp4
0005_01_0054.mp4
0092_06_0005.mp4
0013_01_0032.mp4
0047_02_0026.mp4
0080_01_0002.mp4
0052_01_0102.mp4
0172_05_0002.mp4
0063_01_0084.mp4
0061_02_0062.mp4
0087_06_0023.mp4
0033_01_0016.mp4
0061_02_0079.mp4
0178_01_0011.mp4
0048_02_0033.mp4
0008_01_0129.mp4
0026_01_0043.mp4
0089_03_0011.mp4
0018_06_0038.mp4
0081_01_0042.mp4
0171_00_0004.mp4
0013_03_0015.mp4
0006_01_0124.mp4
0134_02_0008.mp4
0144_00_0001.mp4
0075_01_0078.mp4
0006_01_0117.mp4
0191_04_0004.mp4
0161_01_0017.mp4
0017_01_0075.mp4
0091_03_0034.mp4
0022_01_0133.mp4
0076_03_0004.mp4
0063_01_0041.mp4
0074_02_0041.mp4
0006_02_0072.mp4
0186_01_0016.mp4
0082_02_0009.mp4
0051_01_0143.mp4
0036_02_0006.mp4
0100_01_0002.mp4
0036_02_0048.mp4
0150_01_0006.mp4
0123_02_0006.mp4
0119_06_0008.mp4
0078_06_0054.mp4
0074_03_0028.mp4
0055_01_0012.mp4
0065_02_0009.mp4
0003_02_0124.mp4
0095_01_0014.mp4
0071_05_0008.mp4
0138_03_0009.mp4
0005_01_0067.mp4
0141_04_0006.mp4
0074_03_0016.mp4
0079_02_0006.mp4
0032_01_0036.mp4
0010_01_0087.mp4
0078_02_0116.mp4
0091_01_0040.mp4
0121_01_0008.mp4
0061_06_0037.mp4
0077_05_0023.mp4
0078_02_0080.mp4
0010_02_0053.mp4
0035_01_0011.mp4
0020_03_0077.mp4
0072_01_0064.mp4
0039_02_0036.mp4
0020_03_0018.mp4
0019_01_0045.mp4
0013_01_0001.mp4
0120_03_0008.mp4
0060_03_0007.mp4
0063_01_0029.mp4
0051_01_0097.mp4
0040_03_0002.mp4
0052_02_0025.mp4
0012_02_0010.mp4
0083_05_0005.mp4
0051_02_0020.mp4
0041_05_0012.mp4
0163_00_0007.mp4
0097_03_0003.mp4
0111_02_0008.mp4
0052_01_0074.mp4
0168_01_0017.mp4
0045_03_0001.mp4
0048_01_0018.mp4
0087_01_0031.mp4
0094_02_0027.mp4
0021_02_0084.mp4
0085_02_0022.mp4
0124_01_0025.mp4
0080_03_0003.mp4
0105_01_0003.mp4
0154_02_0001.mp4
0084_03_0029.mp4
0060_01_0068.mp4
0145_02_0010.mp4
0131_00_0005.mp4
0117_01_0002.mp4
0091_00_0006.mp4
0018_00_0003.mp4
0088_03_0018.mp4
0016_03_0185.mp4
0046_03_0048.mp4
0129_04_0005.mp4
0008_01_0128.mp4
0091_00_0004.mp4
0110_01_0025.mp4
0025_01_0051.mp4
0036_01_0044.mp4
0080_01_0125.mp4
0015_06_0011.mp4
0003_02_0110.mp4
0020_01_0051.mp4
0043_03_0008.mp4
0076_01_0024.mp4
0102_01_0020.mp4
0072_02_0004.mp4
0028_06_0027.mp4
0138_03_0004.mp4
0164_02_0006.mp4
0078_02_0065.mp4
0088_02_0002.mp4
0010_03_0085.mp4
0153_03_0008.mp4
0094_02_0038.mp4
0044_02_0003.mp4
0008_01_0009.mp4
0006_01_0037.mp4
0020_01_0046.mp4
0030_02_0034.mp4
0038_01_0007.mp4
0059_01_0055.mp4
0040_05_0003.mp4
0015_01_0007.mp4
0063_01_0016.mp4
0159_02_0002.mp4
0165_02_0008.mp4
0109_02_0019.mp4
0052_01_0258.mp4
0013_05_0003.mp4
0022_02_0004.mp4
0094_01_0008.mp4
0107_02_0033.mp4
0035_01_0006.mp4
0084_03_0006.mp4
0084_01_0058.mp4
0091_01_0010.mp4
0061_01_0076.mp4
0151_03_0007.mp4
0139_05_0007.mp4
0081_02_0017.mp4
0032_03_0008.mp4
0052_04_0009.mp4
0057_02_0001.mp4
0003_01_0017.mp4
0124_01_0026.mp4
0077_01_0021.mp4
0057_01_0069.mp4
0136_01_0019.mp4
0156_02_0011.mp4
0022_06_0103.mp4
0071_02_0012.mp4
0079_02_0019.mp4
0028_02_0029.mp4
0017_01_0059.mp4
0128_02_0004.mp4
0054_03_0037.mp4
0076_02_0078.mp4
0061_02_0035.mp4
0078_01_0005.mp4
0059_01_0020.mp4
0106_02_0002.mp4
0057_01_0048.mp4
0016_06_0076.mp4
0059_03_0013.mp4
0161_02_0012.mp4
0061_06_0009.mp4
0010_03_0004.mp4
0081_02_0062.mp4
0069_01_0068.mp4
0030_01_0024.mp4
0119_06_0015.mp4
0110_05_0011.mp4
0003_01_0064.mp4
0082_02_0014.mp4
0007_02_0030.mp4
0047_02_0101.mp4
0028_01_0003.mp4
0139_01_0001.mp4
0072_03_0017.mp4
0016_03_0017.mp4
0107_02_0041.mp4
0151_02_0021.mp4
0082_02_0023.mp4
0059_03_0003.mp4
0064_01_0148.mp4
0082_01_0060.mp4
0145_05_0011.mp4
0016_00_0063.mp4
0006_06_0084.mp4
0049_03_0034.mp4
0139_06_0005.mp4
0025_03_0027.mp4
0048_02_0072.mp4
0016_03_0007.mp4
0006_02_0012.mp4
0061_06_0043.mp4
0192_03_0016.mp4
0076_01_0026.mp4
0107_00_0025.mp4
0170_01_0005.mp4
0065_01_0034.mp4
0052_01_0132.mp4
0010_02_0219.mp4
0052_01_0117.mp4
0061_03_0014.mp4
0075_06_0010.mp4
0028_05_0011.mp4
0006_01_0011.mp4
0037_03_0007.mp4
0038_06_0004.mp4
0058_01_0001.mp4
0064_06_0003.mp4
0089_02_0022.mp4
0030_02_0050.mp4
0037_01_0013.mp4
0093_01_0006.mp4
0006_06_0094.mp4
0072_01_0046.mp4
0016_00_0058.mp4
0021_02_0087.mp4
0189_06_0001.mp4
0046_01_0026.mp4
0078_01_0115.mp4
0062_01_0004.mp4
0025_04_0016.mp4
0006_01_0055.mp4
0078_01_0128.mp4
0025_02_0022.mp4
0022_01_0049.mp4
0041_01_0038.mp4
0020_06_0027.mp4
0160_02_0006.mp4
0186_01_0024.mp4
0132_01_0002.mp4
0066_01_0010.mp4
0015_01_0326.mp4
0046_06_0004.mp4
0032_03_0003.mp4
0067_03_0017.mp4
0007_01_0026.mp4
0069_01_0081.mp4
0058_05_0003.mp4
0007_01_0093.mp4
0017_01_0066.mp4
0081_02_0015.mp4
0020_01_0073.mp4
0127_01_0001.mp4
0140_03_0023.mp4
0070_01_0019.mp4
0006_06_0015.mp4
0122_06_0005.mp4
0020_01_0110.mp4
0011_03_0002.mp4
0188_06_0004.mp4
0004_01_0096.mp4
0132_04_0003.mp4
0081_01_0014.mp4
0126_02_0017.mp4
0084_02_0004.mp4
0022_01_0027.mp4
0048_02_0101.mp4
0167_06_0004.mp4
0017_01_0168.mp4
0062_02_0008.mp4
0003_02_0021.mp4
0007_02_0023.mp4
0052_01_0048.mp4
0187_01_0008.mp4
0166_01_0009.mp4
0014_03_0010.mp4
0008_01_0146.mp4
0047_01_0022.mp4
0100_01_0011.mp4
0105_01_0021.mp4
0049_02_0018.mp4
0166_01_0008.mp4
0031_02_0040.mp4
0064_01_0034.mp4
0032_05_0013.mp4
0150_05_0004.mp4
0052_01_0201.mp4
0051_01_0118.mp4
0021_01_0016.mp4
0189_06_0006.mp4
0016_00_0010.mp4
0016_03_0009.mp4
0192_05_0002.mp4
0018_02_0010.mp4
0015_03_0001.mp4
