0007_01_0133.mp4
0012_01_0018.mp4
0176_01_0006.mp4
0057_01_0143.mp4
0187_01_0027.mp4
0114_02_0003.mp4
0117_01_0006.mp4
0052_06_0012.mp4
0140_02_0017.mp4
0039_01_0027.mp4
0156_01_0005.mp4
0022_01_0181.mp4
0150_03_0003.mp4
0118_02_0014.mp4
0146_02_0008.mp4
0142_03_0080.mp4
0151_01_0007.mp4
0095_01_0023.mp4
0113_05_0003.mp4
0171_02_0003.mp4
0036_02_0053.mp4
0070_01_0078.mp4
0154_02_0006.mp4
0061_06_0060.mp4
0009_01_0136.mp4
0098_01_0005.mp4
0175_05_0030.mp4
0117_01_0005.mp4
0008_01_0052.mp4
0057_00_0011.mp4
0087_03_0065.mp4
0108_03_0003.mp4
0038_00_0034.mp4
0016_01_0025.mp4
0070_06_0006.mp4
0118_03_0017.mp4
0016_03_0097.mp4
0006_03_0010.mp4
0018_06_0026.mp4
0022_02_0034.mp4
0175_01_0012.mp4
0183_01_0005.mp4
0052_01_0056.mp4
0035_05_0005.mp4
0017_01_0138.mp4
0008_01_0153.mp4
0143_02_0028.mp4
0016_06_0047.mp4
0160_06_0001.mp4
0067_00_0001.mp4
0052_01_0040.mp4
0121_01_0012.mp4
0153_06_0007.mp4
0110_01_0012.mp4
0052_05_0011.mp4
0010_03_0061.mp4
0109_02_0028.mp4
0097_03_0004.mp4
0005_01_0081.mp4
0005_02_0040.mp4
0016_02_0009.mp4
0190_02_0008.mp4
0004_03_0094.mp4
0168_03_0016.mp4
0154_01_0006.mp4
0162_05_0012.mp4
0030_02_0063.mp4
0144_06_0002.mp4
0021_01_0002.mp4
0016_01_0100.mp4
0109_01_0004.mp4
0017_06_0008.mp4
0189_02_0015.mp4
0187_03_0124.mp4
0120_06_0004.mp4
0025_02_0034.mp4
0106_00_0011.mp4
0189_01_0004.mp4
0128_02_0024.mp4
0103_03_0003.mp4
0060_01_0012.mp4
0120_05_0003.mp4
0036_01_0020.mp4
0014_01_0006.mp4
0178_01_0001.mp4
0129_02_0011.mp4
0047_03_0023.mp4
0046_01_0035.mp4
0069_00_0011.mp4
0146_02_0007.mp4
0017_01_0015.mp4
0010_02_0141.mp4
0014_01_0075.mp4
0184_06_0005.mp4
0103_01_0072.mp4
0062_02_0018.mp4
0082_02_0003.mp4
0105_02_0008.mp4
0146_01_0010.mp4
0145_02_0022.mp4
0019_06_0075.mp4
0027_04_0013.mp4
0166_02_0011.mp4
0078_02_0086.mp4
0061_01_0109.mp4
0047_01_0001.mp4
0174_02_0003.mp4
0100_01_0075.mp4
0060_01_0100.mp4
0006_03_0062.mp4
0051_01_0026.mp4
0103_01_0039.mp4
0025_02_0029.mp4
0103_06_0004.mp4
0189_01_0003.mp4
0025_01_0061.mp4
0019_01_0079.mp4
0089_04_0001.mp4
0087_02_0080.mp4
0014_02_0047.mp4
0035_01_0002.mp4
0004_01_0124.mp4
0039_01_0024.mp4
0036_06_0012.mp4
0193_04_0005.mp4
0015_01_0093.mp4
0100_02_0015.mp4
0004_02_0016.mp4
0014_02_0031.mp4
0161_01_0011.mp4
0131_01_0007.mp4
0077_00_0001.mp4
0026_03_0001.mp4
0037_01_0015.mp4
0120_03_0049.mp4
0161_02_0002.mp4
0134_05_0004.mp4
0151_02_0019.mp4
0091_03_0028.mp4
0057_01_0068.mp4
0067_03_0021.mp4
0161_02_0008.mp4
0045_06_0002.mp4
0063_01_0020.mp4
0010_02_0157.mp4
0027_04_0018.mp4
0015_06_0009.mp4
0052_01_0187.mp4
0087_05_0011.mp4
0064_01_0002.mp4
0156_01_0002.mp4
0022_06_0053.mp4
0015_01_0117.mp4
0047_03_0050.mp4
0021_02_0002.mp4
0133_00_0002.mp4
0059_03_0021.mp4
0060_01_0039.mp4
0025_01_0055.mp4
0061_02_0096.mp4
0080_01_0039.mp4
0014_06_0006.mp4
0140_01_0002.mp4
0176_01_0015.mp4
0041_03_0004.mp4
0035_06_0017.mp4
0006_03_0066.mp4
0072_01_0034.mp4
0162_06_0011.mp4
0047_02_0107.mp4
0003_02_0130.mp4
0075_01_0084.mp4
0156_02_0013.mp4
0019_03_0030.mp4
0066_02_0026.mp4
0016_02_0022.mp4
0091_01_0026.mp4
0080_01_0053.mp4
0077_05_0008.mp4
0107_02_0004.mp4
0190_00_0003.mp4
0174_00_0011.mp4
0042_02_0023.mp4
0022_01_0033.mp4
0120_03_0059.mp4
0169_03_0001.mp4
0037_01_0019.mp4
0006_03_0017.mp4
0067_03_0044.mp4
0015_01_0291.mp4
0063_01_0089.mp4
0022_06_0081.mp4
0161_02_0016.mp4
0081_05_0014.mp4
0191_00_0007.mp4
0005_01_0104.mp4
0085_02_0032.mp4
0016_06_0034.mp4
0053_01_0006.mp4
0038_01_0002.mp4
0031_06_0024.mp4
0057_01_0020.mp4
0110_03_0013.mp4
0066_02_0013.mp4
0016_03_0134.mp4
0110_01_0023.mp4
0017_05_0005.mp4
0189_01_0026.mp4
0004_01_0055.mp4
0017_01_0019.mp4
0161_01_0002.mp4
0026_02_0031.mp4
0048_02_0079.mp4
0082_01_0027.mp4
0061_01_0084.mp4
0015_04_0021.mp4
0003_01_0048.mp4
0047_03_0015.mp4
0041_02_0022.mp4
0077_01_0029.mp4
0009_01_0059.mp4
0084_01_0018.mp4
0016_00_0069.mp4
0013_01_0031.mp4
0010_01_0079.mp4
0010_01_0071.mp4
0036_01_0025.mp4
0118_01_0010.mp4
0150_02_0010.mp4
0063_01_0079.mp4
0078_02_0140.mp4
0161_02_0017.mp4
0016_03_0020.mp4
0081_01_0024.mp4
0100_01_0044.mp4
0020_01_0065.mp4
0009_01_0010.mp4
0062_06_0001.mp4
0139_06_0001.mp4
0017_01_0146.mp4
0073_02_0001.mp4
0015_01_0331.mp4
0005_02_0033.mp4
0009_01_0112.mp4
0057_02_0008.mp4
0081_02_0023.mp4
0019_06_0059.mp4
0075_01_0090.mp4
0070_01_0099.mp4
0021_02_0098.mp4
0030_02_0022.mp4
0061_01_0167.mp4
0057_02_0004.mp4
0061_01_0144.mp4
0135_06_0015.mp4
0009_01_0039.mp4
0013_06_0029.mp4
0101_01_0002.mp4
0007_01_0125.mp4
0190_02_0003.mp4
0061_05_0001.mp4
0052_01_0087.mp4
0034_04_0004.mp4
0006_02_0018.mp4
0006_03_0045.mp4
0107_02_0036.mp4
0004_03_0048.mp4
0140_03_0002.mp4
0039_02_0018.mp4
0004_01_0044.mp4
0006_02_0161.mp4
0105_02_0025.mp4
0132_05_0003.mp4
0178_00_0004.mp4
0112_06_0003.mp4
0175_02_0019.mp4
0059_03_0007.mp4
0042_00_0005.mp4
0150_01_0020.mp4
0143_02_0016.mp4
0104_06_0011.mp4
0133_02_0012.mp4
0081_02_0066.mp4
0064_01_0185.mp4
0064_01_0163.mp4
0078_02_0121.mp4
0006_06_0026.mp4
0016_00_0085.mp4
0049_02_0010.mp4
0004_03_0007.mp4
0016_03_0177.mp4
0097_03_0010.mp4
0171_01_0022.mp4
0005_01_0014.mp4
0187_03_0002.mp4
0087_01_0004.mp4
0061_01_0096.mp4
0143_01_0022.mp4
0061_05_0005.mp4
0015_02_0001.mp4
0026_05_0006.mp4
0139_02_0025.mp4
0072_01_0070.mp4
0052_01_0029.mp4
0038_01_0024.mp4
0105_01_0017.mp4
0071_01_0085.mp4
0009_01_0117.mp4
0082_01_0054.mp4
0075_02_0033.mp4
0080_01_0104.mp4
0150_02_0014.mp4
0008_01_0115.mp4
0015_04_0031.mp4
0142_03_0092.mp4
0071_01_0052.mp4
0020_01_0074.mp4
0080_06_0004.mp4
0026_01_0003.mp4
0191_02_0034.mp4
0038_00_0011.mp4
0004_05_0037.mp4
0188_03_0014.mp4
0017_01_0103.mp4
0016_03_0183.mp4
0004_01_0026.mp4
0030_00_0010.mp4
0178_02_0023.mp4
0007_02_0021.mp4
0101_01_0011.mp4
0096_01_0070.mp4
0121_06_0003.mp4
0006_01_0096.mp4
0058_01_0031.mp4
0016_01_0119.mp4
0027_06_0032.mp4
0037_01_0014.mp4
0030_02_0102.mp4
0114_01_0006.mp4
0137_03_0018.mp4
0155_01_0008.mp4
0075_01_0061.mp4
0165_03_0018.mp4
0010_03_0034.mp4
0089_01_0044.mp4
0022_01_0017.mp4
0004_03_0006.mp4
0054_02_0059.mp4
0075_01_0052.mp4
0007_01_0027.mp4
0153_01_0001.mp4
0093_01_0031.mp4
0120_06_0001.mp4
0191_02_0008.mp4
0022_06_0011.mp4
0096_01_0001.mp4
0176_02_0004.mp4
0140_02_0002.mp4
0105_01_0014.mp4
0004_02_0030.mp4
0143_01_0019.mp4
0155_02_0001.mp4
0022_01_0126.mp4
0070_05_0005.mp4
0168_00_0004.mp4
0109_06_0024.mp4
0101_01_0025.mp4
0078_02_0020.mp4
0065_02_0006.mp4
0091_01_0023.mp4
0168_01_0015.mp4
0014_02_0017.mp4
0052_01_0235.mp4
0006_01_0019.mp4
0017_03_0007.mp4
