0137_02_0011.mp4
0052_01_0261.mp4
0054_03_0042.mp4
0124_05_0006.mp4
0030_01_0029.mp4
0160_01_0010.mp4
0060_01_0107.mp4
0010_02_0137.mp4
0047_02_0038.mp4
0139_05_0003.mp4
0136_02_0001.mp4
0007_01_0109.mp4
0140_02_0014.mp4
0039_01_0037.mp4
0027_02_0005.mp4
0086_03_0004.mp4
0065_01_0011.mp4
0032_01_0028.mp4
0048_02_0021.mp4
0080_01_0052.mp4
0186_04_0005.mp4
0016_03_0022.mp4
0089_02_0038.mp4
0156_02_0010.mp4
0115_02_0025.mp4
0115_01_0005.mp4
0151_02_0018.mp4
0164_05_0002.mp4
0006_02_0110.mp4
0096_01_0045.mp4
0045_01_0003.mp4
0032_02_0053.mp4
0016_03_0112.mp4
0049_03_0011.mp4
0137_05_0003.mp4
0008_01_0177.mp4
0020_06_0003.mp4
0069_01_0043.mp4
0105_05_0004.mp4
0138_01_0008.mp4
0139_04_0001.mp4
0061_03_0023.mp4
0071_03_0010.mp4
0104_06_0022.mp4
0101_00_0008.mp4
0115_02_0018.mp4
0003_02_0080.mp4
0083_02_0001.mp4
0064_01_0176.mp4
0079_01_0011.mp4
0060_01_0088.mp4
0128_02_0012.mp4
0051_01_0068.mp4
0016_03_0041.mp4
0004_01_0181.mp4
0031_06_0014.mp4
0091_01_0047.mp4
0003_02_0010.mp4
0154_02_0004.mp4
0016_03_0220.mp4
0075_02_0095.mp4
0129_01_0004.mp4
0147_02_0009.mp4
0087_01_0036.mp4
0069_01_0127.mp4
0114_03_0003.mp4
0074_02_0005.mp4
0132_00_0003.mp4
0045_02_0011.mp4
0156_02_0012.mp4
0026_04_0001.mp4
0039_03_0001.mp4
0016_03_0184.mp4
0059_01_0085.mp4
0070_01_0039.mp4
0020_03_0052.mp4
0075_01_0012.mp4
0052_01_0204.mp4
0020_00_0011.mp4
0015_01_0238.mp4
0133_03_0019.mp4
0003_02_0048.mp4
0039_01_0015.mp4
0167_02_0006.mp4
0007_01_0139.mp4
0022_01_0084.mp4
0021_01_0009.mp4
0080_01_0036.mp4
0073_06_0001.mp4
0019_02_0037.mp4
0082_01_0013.mp4
0039_05_0011.mp4
0083_01_0015.mp4
0006_03_0059.mp4
0030_02_0084.mp4
0095_01_0017.mp4
0100_01_0038.mp4
0047_05_0001.mp4
0076_02_0066.mp4
0016_01_0044.mp4
0014_01_0117.mp4
0006_01_0104.mp4
0087_02_0007.mp4
0063_01_0055.mp4
0047_01_0018.mp4
0112_02_0010.mp4
0027_02_0011.mp4
0052_02_0027.mp4
0006_06_0101.mp4
0078_02_0019.mp4
0153_01_0014.mp4
0021_02_0113.mp4
0068_01_0007.mp4
0089_00_0003.mp4
0032_01_0074.mp4
0016_06_0056.mp4
0022_01_0004.mp4
0016_01_0065.mp4
0032_02_0043.mp4
0061_03_0001.mp4
0101_03_0005.mp4
0067_01_0011.mp4
0130_00_0022.mp4
0076_02_0043.mp4
0052_01_0042.mp4
0004_05_0034.mp4
0081_01_0045.mp4
0096_01_0032.mp4
0091_01_0030.mp4
0014_01_0114.mp4
0137_03_0001.mp4
0144_03_0014.mp4
0028_02_0013.mp4
0191_02_0006.mp4
0041_00_0007.mp4
0005_05_0010.mp4
0016_03_0209.mp4
0161_03_0006.mp4
0081_02_0074.mp4
0081_02_0003.mp4
0005_03_0007.mp4
0003_01_0050.mp4
0047_02_0089.mp4
0070_01_0061.mp4
0107_01_0003.mp4
0119_05_0005.mp4
0068_02_0020.mp4
0063_01_0072.mp4
0052_04_0010.mp4
0137_03_0010.mp4
0148_02_0013.mp4
0073_04_0001.mp4
0017_01_0068.mp4
0144_02_0023.mp4
0119_05_0020.mp4
0101_01_0019.mp4
0052_01_0247.mp4
0105_02_0007.mp4
0191_01_0008.mp4
0006_02_0017.mp4
0158_01_0005.mp4
0047_02_0118.mp4
0129_02_0003.mp4
0124_01_0022.mp4
0006_06_0089.mp4
0128_02_0013.mp4
0052_05_0035.mp4
0099_01_0008.mp4
0066_06_0001.mp4
0017_01_0188.mp4
0006_02_0167.mp4
0180_03_0009.mp4
0018_06_0044.mp4
0035_03_0023.mp4
0076_02_0126.mp4
0022_01_0227.mp4
0004_03_0041.mp4
0161_00_0010.mp4
0073_01_0003.mp4
0010_01_0003.mp4
0084_06_0020.mp4
0069_02_0004.mp4
0018_02_0011.mp4
0164_06_0016.mp4
0074_05_0007.mp4
0140_02_0006.mp4
0010_02_0021.mp4
0027_01_0030.mp4
0013_02_0033.mp4
0017_01_0123.mp4
0068_01_0015.mp4
0078_01_0096.mp4
0075_00_0024.mp4
0048_00_0006.mp4
0048_02_0086.mp4
0022_06_0082.mp4
0094_06_0012.mp4
0165_05_0006.mp4
0013_01_0036.mp4
0003_02_0114.mp4
0065_01_0023.mp4
0151_06_0013.mp4
0066_01_0020.mp4
0003_02_0139.mp4
0010_01_0023.mp4
0136_02_0013.mp4
0070_01_0060.mp4
0061_04_0012.mp4
0070_01_0076.mp4
0130_02_0002.mp4
0020_06_0030.mp4
0006_02_0007.mp4
0057_02_0018.mp4
0058_01_0029.mp4
0038_02_0029.mp4
0009_01_0132.mp4
0103_06_0003.mp4
0089_03_0052.mp4
0007_01_0137.mp4
0148_02_0025.mp4
0147_02_0012.mp4
0016_03_0117.mp4
0139_05_0010.mp4
0095_01_0009.mp4
0069_01_0091.mp4
0117_01_0017.mp4
0064_05_0020.mp4
0020_06_0041.mp4
0006_03_0012.mp4
0061_01_0051.mp4
0063_01_0188.mp4
0061_01_0168.mp4
0078_03_0016.mp4
0190_01_0001.mp4
0060_01_0062.mp4
0054_02_0006.mp4
0029_02_0001.mp4
0022_01_0069.mp4
0050_06_0001.mp4
0012_02_0016.mp4
0076_02_0148.mp4
0099_00_0005.mp4
0015_01_0286.mp4
0089_02_0032.mp4
0047_03_0003.mp4
0119_03_0007.mp4
0142_02_0005.mp4
0007_01_0091.mp4
0140_01_0001.mp4
0012_01_0010.mp4
0058_03_0005.mp4
0051_01_0011.mp4
0050_06_0003.mp4
0061_01_0001.mp4
0007_01_0069.mp4
0188_00_0003.mp4
0065_01_0028.mp4
0033_02_0002.mp4
0032_01_0063.mp4
0124_01_0015.mp4
0047_01_0005.mp4
0066_06_0005.mp4
0059_03_0023.mp4
0019_06_0008.mp4
0176_00_0003.mp4
0030_02_0032.mp4
0075_01_0097.mp4
0094_02_0016.mp4
0006_02_0120.mp4
0089_02_0057.mp4
0005_01_0078.mp4
0016_00_0044.mp4
0142_01_0013.mp4
0004_01_0012.mp4
0006_03_0032.mp4
0054_02_0021.mp4
0004_01_0053.mp4
0006_06_0036.mp4
0072_03_0014.mp4
0102_01_0003.mp4
0095_01_0026.mp4
0124_01_0013.mp4
0156_03_0008.mp4
0014_01_0011.mp4
0064_00_0007.mp4
0150_02_0012.mp4
0026_02_0005.mp4
0032_05_0008.mp4
0052_01_0272.mp4
0079_01_0006.mp4
0081_02_0032.mp4
0028_05_0019.mp4
0010_02_0116.mp4
0021_02_0051.mp4
0091_03_0012.mp4
0026_01_0011.mp4
0101_03_0011.mp4
0003_02_0128.mp4
0100_01_0035.mp4
0085_01_0041.mp4
0049_02_0023.mp4
0006_05_0012.mp4
0054_04_0007.mp4
0060_01_0122.mp4
0186_02_0015.mp4
0016_03_0153.mp4
0009_01_0082.mp4
0028_05_0007.mp4
0134_02_0017.mp4
0016_03_0128.mp4
0095_01_0029.mp4
0116_02_0021.mp4
0141_06_0007.mp4
0075_00_0036.mp4
0006_02_0002.mp4
0061_01_0102.mp4
0054_03_0034.mp4
0075_00_0033.mp4
0161_01_0001.mp4
0031_06_0027.mp4
0057_01_0088.mp4
0006_01_0114.mp4
0141_06_0009.mp4
0179_04_0011.mp4
0013_03_0023.mp4
0052_01_0058.mp4
0144_03_0001.mp4
0142_03_0115.mp4
0115_02_0007.mp4
0081_02_0005.mp4
0137_03_0011.mp4
0176_00_0001.mp4
0016_06_0012.mp4
0118_01_0015.mp4
0159_01_0018.mp4
0014_01_0020.mp4
0120_02_0002.mp4
0084_03_0022.mp4
0179_05_0002.mp4
0020_03_0038.mp4
0034_06_0001.mp4
0178_06_0011.mp4
0083_06_0005.mp4
0022_01_0103.mp4
0004_01_0056.mp4
0010_02_0181.mp4
0191_01_0001.mp4
0017_06_0006.mp4
0072_01_0056.mp4
0019_00_0001.mp4
0130_00_0005.mp4
0148_01_0004.mp4
0059_02_0027.mp4
0015_02_0002.mp4
0015_01_0314.mp4
0014_01_0109.mp4
0072_01_0066.mp4
0039_01_0029.mp4
0187_03_0010.mp4
0095_01_0043.mp4
0154_06_0002.mp4
0080_01_0035.mp4
0016_03_0154.mp4
0064_01_0065.mp4
0156_02_0004.mp4
0183_01_0014.mp4
0085_01_0077.mp4
0148_00_0003.mp4
0148_01_0028.mp4
0012_03_0005.mp4
0095_01_0012.mp4
0035_00_0021.mp4
0003_01_0043.mp4
0015_01_0068.mp4
0149_01_0001.mp4
