0086_06_0009.mp4
0007_01_0022.mp4
0088_02_0022.mp4
0041_02_0012.mp4
0015_04_0052.mp4
0051_03_0009.mp4
0103_04_0008.mp4
0136_01_0017.mp4
0096_02_0031.mp4
0012_02_0014.mp4
0010_01_0066.mp4
0004_01_0014.mp4
0054_03_0006.mp4
0142_01_0024.mp4
0034_00_0001.mp4
0041_06_0013.mp4
0015_01_0284.mp4
0101_01_0007.mp4
0020_02_0013.mp4
0070_01_0049.mp4
0048_02_0060.mp4
0010_03_0049.mp4
0096_01_0067.mp4
0148_01_0017.mp4
0008_01_0148.mp4
0021_02_0060.mp4
0004_03_0085.mp4
0072_02_0018.mp4
0061_01_0021.mp4
0016_00_0080.mp4
0144_02_0001.mp4
0063_01_0094.mp4
0010_01_0033.mp4
0040_02_0018.mp4
0061_01_0185.mp4
0014_02_0034.mp4
0045_06_0001.mp4
0180_02_0005.mp4
0004_03_0049.mp4
0035_05_0018.mp4
0019_02_0049.mp4
0104_06_0005.mp4
0020_05_0006.mp4
0066_03_0009.mp4
0092_02_0001.mp4
0010_02_0143.mp4
0047_02_0053.mp4
0064_01_0140.mp4
0025_02_0002.mp4
0188_02_0002.mp4
0008_01_0026.mp4
0135_03_0011.mp4
0064_01_0025.mp4
0044_06_0019.mp4
0139_01_0006.mp4
0053_05_0010.mp4
0061_01_0103.mp4
0119_00_0006.mp4
0047_03_0091.mp4
0069_01_0065.mp4
0126_02_0009.mp4
0071_01_0024.mp4
0026_02_0038.mp4
0012_05_0005.mp4
0118_04_0006.mp4
0148_01_0016.mp4
0114_06_0002.mp4
0089_04_0009.mp4
0028_06_0031.mp4
0022_01_0060.mp4
0039_05_0004.mp4
0144_02_0022.mp4
0145_02_0006.mp4
0016_00_0001.mp4
0114_01_0010.mp4
0036_01_0039.mp4
0047_01_0011.mp4
0096_02_0006.mp4
0047_02_0016.mp4
0013_03_0022.mp4
0020_01_0067.mp4
0006_01_0012.mp4
0026_01_0065.mp4
0094_01_0035.mp4
0021_01_0044.mp4
0072_03_0010.mp4
0180_02_0026.mp4
0133_01_0014.mp4
0104_01_0014.mp4
0078_03_0019.mp4
0120_05_0010.mp4
0091_03_0033.mp4
0078_01_0006.mp4
0108_02_0003.mp4
0005_01_0034.mp4
0021_02_0075.mp4
0105_01_0006.mp4
0008_01_0138.mp4
0076_02_0076.mp4
0014_02_0028.mp4
0011_01_0009.mp4
0020_06_0002.mp4
0007_01_0086.mp4
0013_05_0004.mp4
0017_01_0010.mp4
0135_02_0006.mp4
0094_00_0006.mp4
0079_02_0009.mp4
0039_05_0008.mp4
0016_03_0204.mp4
0084_06_0007.mp4
0019_06_0005.mp4
0165_02_0001.mp4
0015_01_0158.mp4
0093_06_0002.mp4
0022_02_0032.mp4
0031_03_0009.mp4
0139_02_0030.mp4
0080_01_0111.mp4
0064_01_0005.mp4
0003_02_0098.mp4
0075_01_0095.mp4
0187_03_0013.mp4
0127_01_0002.mp4
0169_03_0003.mp4
0048_02_0056.mp4
0022_01_0113.mp4
0144_06_0001.mp4
0143_03_0016.mp4
0136_01_0001.mp4
0030_02_0043.mp4
0003_02_0093.mp4
0186_01_0015.mp4
0013_03_0026.mp4
0006_02_0056.mp4
0035_06_0023.mp4
0145_06_0003.mp4
0042_01_0009.mp4
0070_01_0112.mp4
0104_04_0002.mp4
0183_01_0001.mp4
0009_03_0006.mp4
0163_01_0032.mp4
0080_05_0002.mp4
0078_02_0002.mp4
0091_01_0035.mp4
0152_02_0005.mp4
0027_04_0027.mp4
0072_02_0019.mp4
0014_01_0004.mp4
0179_06_0008.mp4
0041_00_0018.mp4
0069_01_0058.mp4
0117_01_0009.mp4
0021_01_0048.mp4
0112_00_0012.mp4
0076_01_0012.mp4
0014_01_0032.mp4
0035_00_0019.mp4
0191_02_0019.mp4
0082_01_0024.mp4
0091_02_0017.mp4
0079_02_0021.mp4
0119_02_0008.mp4
0085_01_0092.mp4
0164_03_0013.mp4
0172_04_0001.mp4
0022_01_0273.mp4
0049_03_0082.mp4
0015_01_0046.mp4
0040_06_0012.mp4
0138_01_0017.mp4
0010_02_0110.mp4
0015_01_0166.mp4
0154_01_0008.mp4
0087_01_0056.mp4
0047_04_0003.mp4
0019_02_0011.mp4
0142_03_0104.mp4
0161_05_0025.mp4
0175_03_0003.mp4
0178_03_0019.mp4
0082_01_0075.mp4
0022_01_0131.mp4
0052_01_0279.mp4
0047_02_0011.mp4
0147_00_0001.mp4
0006_02_0003.mp4
0066_02_0027.mp4
0135_01_0007.mp4
0122_02_0022.mp4
0120_03_0007.mp4
0016_00_0040.mp4
0025_03_0017.mp4
0143_02_0005.mp4
0011_06_0019.mp4
0187_03_0111.mp4
0110_04_0004.mp4
0082_06_0054.mp4
0082_06_0052.mp4
0004_01_0071.mp4
0064_01_0110.mp4
0051_01_0088.mp4
0060_06_0001.mp4
0100_02_0002.mp4
0016_01_0071.mp4
0015_01_0097.mp4
0033_05_0002.mp4
0016_00_0034.mp4
0004_01_0041.mp4
0174_06_0001.mp4
0018_06_0062.mp4
0188_05_0002.mp4
0036_06_0001.mp4
0035_03_0020.mp4
0010_02_0097.mp4
0081_06_0004.mp4
0193_03_0003.mp4
0061_01_0003.mp4
0154_05_0006.mp4
0011_00_0014.mp4
0094_01_0011.mp4
0052_02_0007.mp4
0070_01_0071.mp4
0151_05_0006.mp4
0069_05_0007.mp4
0005_01_0041.mp4
0135_06_0001.mp4
0102_01_0034.mp4
0127_00_0001.mp4
0062_01_0020.mp4
0006_06_0083.mp4
0137_03_0004.mp4
0112_01_0018.mp4
0051_01_0144.mp4
0052_01_0095.mp4
0080_06_0006.mp4
0081_01_0021.mp4
0084_01_0037.mp4
0016_06_0074.mp4
0036_02_0027.mp4
0028_01_0032.mp4
0006_01_0058.mp4
0004_01_0028.mp4
0187_03_0045.mp4
0165_01_0004.mp4
0080_03_0012.mp4
0070_01_0126.mp4
0052_01_0199.mp4
0076_02_0131.mp4
0006_02_0130.mp4
0094_01_0012.mp4
0151_02_0017.mp4
0176_01_0004.mp4
0010_02_0228.mp4
0017_01_0078.mp4
0058_01_0065.mp4
0015_01_0266.mp4
0065_02_0020.mp4
0051_01_0074.mp4
0025_03_0029.mp4
0161_05_0001.mp4
0015_01_0232.mp4
0022_01_0005.mp4
0143_04_0001.mp4
0039_02_0038.mp4
0097_06_0024.mp4
0147_01_0010.mp4
0109_00_0009.mp4
0103_02_0045.mp4
0009_02_0001.mp4
0032_06_0002.mp4
0051_01_0136.mp4
0087_03_0030.mp4
0084_06_0009.mp4
0038_02_0026.mp4
0103_02_0019.mp4
0071_02_0021.mp4
0074_03_0019.mp4
0121_03_0013.mp4
0072_05_0009.mp4
0020_01_0052.mp4
0075_01_0107.mp4
0119_01_0014.mp4
0089_01_0021.mp4
0048_02_0027.mp4
0035_05_0030.mp4
0005_02_0017.mp4
0157_02_0005.mp4
0106_03_0009.mp4
0047_02_0104.mp4
0092_01_0017.mp4
0050_01_0023.mp4
0080_03_0005.mp4
0022_01_0243.mp4
0093_01_0029.mp4
0022_01_0258.mp4
0027_05_0003.mp4
0028_05_0018.mp4
0014_02_0054.mp4
0022_02_0006.mp4
0143_05_0011.mp4
0004_05_0022.mp4
0008_01_0051.mp4
0188_05_0004.mp4
0157_03_0003.mp4
0189_01_0025.mp4
0051_02_0003.mp4
0152_01_0002.mp4
0077_05_0027.mp4
0069_01_0003.mp4
0191_06_0004.mp4
0097_06_0013.mp4
0144_06_0003.mp4
0010_03_0024.mp4
0058_03_0001.mp4
0006_02_0069.mp4
0016_06_0019.mp4
0052_01_0288.mp4
0166_01_0026.mp4
0193_02_0005.mp4
0019_01_0069.mp4
0077_01_0030.mp4
0113_02_0004.mp4
0048_02_0063.mp4
0091_03_0039.mp4
0047_01_0030.mp4
0032_01_0056.mp4
0176_02_0006.mp4
0057_06_0009.mp4
0006_02_0138.mp4
0012_06_0006.mp4
0006_02_0044.mp4
0085_01_0076.mp4
0085_02_0029.mp4
0017_01_0097.mp4
0009_00_0003.mp4
0015_05_0013.mp4
0191_02_0017.mp4
0061_01_0171.mp4
0057_01_0086.mp4
0097_01_0002.mp4
0106_03_0013.mp4
0128_05_0006.mp4
0051_01_0133.mp4
0062_01_0007.mp4
0035_04_0001.mp4
0152_01_0013.mp4
0069_03_0003.mp4
0189_04_0001.mp4
0060_00_0004.mp4
0049_03_0032.mp4
0006_01_0049.mp4
0026_01_0034.mp4
0062_01_0002.mp4
0141_03_0001.mp4
0093_01_0023.mp4
0010_03_0014.mp4
0008_01_0070.mp4
0025_03_0039.mp4
0162_05_0009.mp4
0067_03_0031.mp4
0003_02_0020.mp4
0019_06_0061.mp4
0006_01_0053.mp4
0004_05_0013.mp4
0070_01_0121.mp4
0137_02_0005.mp4
0117_01_0012.mp4
0020_04_0002.mp4
0030_01_0010.mp4
0134_06_0009.mp4
0126_01_0006.mp4
0091_01_0051.mp4
0039_01_0039.mp4
