0041_01_0001.mp4
0010_02_0150.mp4
0165_01_0017.mp4
0006_04_0003.mp4
0182_06_0001.mp4
0019_03_0034.mp4
0151_01_0005.mp4
0190_02_0001.mp4
0108_02_0009.mp4
0069_01_0036.mp4
0077_01_0023.mp4
0165_00_0007.mp4
0009_01_0110.mp4
0051_02_0019.mp4
0082_01_0069.mp4
0065_02_0030.mp4
0164_02_0017.mp4
0086_01_0020.mp4
0065_02_0004.mp4
0085_01_0022.mp4
0022_01_0190.mp4
0080_01_0155.mp4
0175_02_0015.mp4
0058_01_0043.mp4
0054_03_0035.mp4
0061_03_0003.mp4
0013_00_0001.mp4
0140_05_0002.mp4
0061_01_0034.mp4
0054_02_0024.mp4
0122_06_0004.mp4
0026_01_0008.mp4
0145_02_0024.mp4
0157_06_0013.mp4
0080_01_0105.mp4
0013_02_0007.mp4
0049_03_0098.mp4
0110_03_0016.mp4
0152_03_0002.mp4
0103_01_0010.mp4
0102_04_0012.mp4
0027_02_0026.mp4
0063_01_0142.mp4
0073_03_0007.mp4
0083_03_0028.mp4
0076_01_0036.mp4
0082_06_0010.mp4
0069_05_0009.mp4
0016_06_0067.mp4
0051_01_0152.mp4
0062_00_0006.mp4
0008_01_0068.mp4
0067_01_0010.mp4
0052_03_0005.mp4
0028_02_0001.mp4
0006_06_0039.mp4
0047_02_0055.mp4
0094_01_0014.mp4
0121_02_0007.mp4
0075_05_0003.mp4
0109_02_0018.mp4
0059_01_0045.mp4
0059_05_0026.mp4
0007_01_0095.mp4
0030_02_0049.mp4
0007_02_0017.mp4
0030_04_0013.mp4
0054_02_0017.mp4
0006_06_0046.mp4
0088_06_0006.mp4
0010_02_0011.mp4
0018_06_0009.mp4
0026_01_0063.mp4
0095_02_0034.mp4
0175_05_0005.mp4
0158_01_0002.mp4
0160_01_0003.mp4
0123_02_0002.mp4
0155_06_0003.mp4
0007_02_0027.mp4
0018_00_0005.mp4
0062_01_0014.mp4
0015_03_0002.mp4
0042_01_0032.mp4
0064_01_0117.mp4
0010_02_0158.mp4
0067_01_0012.mp4
0004_03_0092.mp4
0047_02_0067.mp4
0070_01_0153.mp4
0074_00_0004.mp4
0007_02_0009.mp4
0092_05_0003.mp4
0074_05_0002.mp4
0172_01_0014.mp4
0128_01_0008.mp4
0106_02_0020.mp4
0143_03_0007.mp4
0122_01_0001.mp4
0114_00_0009.mp4
0010_02_0162.mp4
0068_02_0001.mp4
0112_03_0008.mp4
0168_05_0008.mp4
0027_02_0048.mp4
0078_02_0133.mp4
0136_03_0030.mp4
0042_01_0011.mp4
0065_03_0006.mp4
0003_01_0062.mp4
0081_02_0001.mp4
0054_00_0015.mp4
0019_06_0020.mp4
0042_02_0013.mp4
0138_02_0010.mp4
0109_02_0014.mp4
0004_03_0095.mp4
0119_03_0005.mp4
0103_02_0016.mp4
0146_00_0001.mp4
0010_01_0101.mp4
0088_05_0003.mp4
0147_00_0004.mp4
0041_03_0002.mp4
0008_01_0066.mp4
0016_03_0198.mp4
0057_01_0079.mp4
0041_02_0020.mp4
0164_05_0008.mp4
0016_01_0030.mp4
0080_01_0072.mp4
0115_02_0006.mp4
0124_02_0020.mp4
0020_01_0126.mp4
0035_05_0015.mp4
0144_01_0008.mp4
0005_01_0039.mp4
0012_06_0034.mp4
0003_02_0102.mp4
0086_06_0003.mp4
0092_02_0017.mp4
0019_01_0054.mp4
0093_04_0001.mp4
0177_06_0009.mp4
0006_06_0085.mp4
0019_01_0017.mp4
0020_01_0008.mp4
0063_01_0019.mp4
0015_01_0200.mp4
0060_01_0112.mp4
0006_02_0042.mp4
0038_01_0004.mp4
0070_06_0022.mp4
0013_01_0028.mp4
0073_01_0014.mp4
0041_00_0001.mp4
0189_01_0014.mp4
0104_01_0011.mp4
0075_02_0044.mp4
0008_05_0005.mp4
0153_00_0005.mp4
0006_01_0111.mp4
0064_05_0028.mp4
0087_02_0036.mp4
0036_06_0014.mp4
0014_02_0049.mp4
0082_06_0033.mp4
0176_02_0003.mp4
0108_02_0015.mp4
0087_00_0012.mp4
0051_01_0139.mp4
0021_03_0001.mp4
0013_03_0014.mp4
0052_02_0003.mp4
0016_06_0077.mp4
0109_02_0029.mp4
0166_03_0002.mp4
0128_02_0006.mp4
0070_01_0093.mp4
0096_01_0044.mp4
0008_01_0181.mp4
0047_00_0014.mp4
0175_00_0006.mp4
0030_02_0054.mp4
0022_01_0038.mp4
0078_06_0041.mp4
0115_01_0016.mp4
0104_01_0038.mp4
0072_01_0028.mp4
0182_02_0013.mp4
0187_00_0003.mp4
0084_01_0017.mp4
0136_03_0016.mp4
0069_05_0003.mp4
0028_06_0011.mp4
0092_02_0014.mp4
0059_01_0028.mp4
0041_05_0011.mp4
0118_04_0003.mp4
0040_02_0022.mp4
0086_06_0028.mp4
0052_02_0001.mp4
0085_01_0030.mp4
0041_02_0017.mp4
0069_01_0070.mp4
0078_01_0083.mp4
0161_00_0003.mp4
0082_06_0038.mp4
0022_01_0147.mp4
0026_01_0018.mp4
0022_01_0044.mp4
0020_06_0020.mp4
0071_01_0040.mp4
0017_01_0175.mp4
0063_01_0061.mp4
0006_06_0069.mp4
0114_02_0001.mp4
0120_02_0012.mp4
0189_01_0018.mp4
0015_01_0267.mp4
0054_03_0039.mp4
0012_01_0031.mp4
0020_06_0039.mp4
0019_01_0016.mp4
0038_02_0025.mp4
0028_02_0034.mp4
0097_06_0027.mp4
0064_00_0012.mp4
0035_02_0003.mp4
0026_00_0021.mp4
0059_01_0011.mp4
0069_01_0017.mp4
0005_01_0010.mp4
0144_03_0013.mp4
0106_04_0001.mp4
0080_01_0075.mp4
0015_01_0008.mp4
0114_01_0011.mp4
0017_01_0077.mp4
0061_03_0018.mp4
0071_01_0039.mp4
0175_04_0004.mp4
0059_01_0031.mp4
0013_05_0001.mp4
0017_01_0106.mp4
0075_01_0005.mp4
0059_01_0049.mp4
0064_06_0009.mp4
0019_02_0047.mp4
0140_03_0035.mp4
0013_01_0026.mp4
0062_02_0001.mp4
0020_02_0014.mp4
0047_02_0018.mp4
0052_01_0270.mp4
0073_03_0004.mp4
0130_00_0014.mp4
0015_01_0047.mp4
0061_05_0018.mp4
0010_02_0111.mp4
0063_00_0001.mp4
0008_01_0187.mp4
0063_01_0108.mp4
0078_01_0015.mp4
0074_01_0007.mp4
0161_02_0005.mp4
0070_01_0141.mp4
0069_01_0055.mp4
0021_02_0068.mp4
0112_02_0007.mp4
0112_06_0005.mp4
0083_03_0017.mp4
0182_02_0004.mp4
0046_01_0011.mp4
0007_00_0003.mp4
0022_06_0050.mp4
0104_06_0021.mp4
0013_03_0025.mp4
0064_01_0059.mp4
0015_02_0011.mp4
0164_06_0018.mp4
0010_01_0075.mp4
0175_00_0003.mp4
0103_06_0009.mp4
0094_03_0006.mp4
0061_01_0046.mp4
0027_04_0024.mp4
0137_01_0003.mp4
0087_01_0019.mp4
0170_06_0006.mp4
0128_02_0001.mp4
0139_05_0014.mp4
0089_04_0002.mp4
0072_02_0020.mp4
0106_01_0014.mp4
0154_01_0012.mp4
0012_01_0021.mp4
0052_04_0018.mp4
0070_01_0006.mp4
0009_01_0097.mp4
0006_06_0067.mp4
0087_03_0004.mp4
0089_03_0014.mp4
0187_01_0004.mp4
0011_00_0041.mp4
0106_02_0013.mp4
0065_02_0012.mp4
0009_01_0074.mp4
0051_03_0002.mp4
0057_01_0114.mp4
0163_02_0013.mp4
0092_02_0008.mp4
0010_02_0176.mp4
0083_05_0004.mp4
0020_03_0027.mp4
0060_01_0024.mp4
0061_01_0105.mp4
0134_02_0011.mp4
0086_06_0026.mp4
0139_04_0003.mp4
0134_00_0012.mp4
0090_01_0014.mp4
0102_01_0016.mp4
0025_02_0026.mp4
0011_06_0003.mp4
0189_01_0015.mp4
0022_06_0089.mp4
0030_01_0031.mp4
0047_03_0014.mp4
0020_01_0018.mp4
0180_00_0001.mp4
0041_01_0021.mp4
0020_01_0054.mp4
0065_01_0032.mp4
0064_05_0022.mp4
0028_06_0007.mp4
0107_01_0008.mp4
0116_04_0005.mp4
0016_01_0139.mp4
0107_01_0025.mp4
0012_01_0011.mp4
0022_01_0246.mp4
0062_01_0033.mp4
0168_03_0007.mp4
0063_01_0160.mp4
0059_01_0053.mp4
0156_02_0008.mp4
0012_06_0008.mp4
0112_06_0001.mp4
0076_02_0004.mp4
0142_05_0004.mp4
0082_02_0005.mp4
0168_03_0004.mp4
0015_05_0006.mp4
0082_03_0007.mp4
0014_01_0068.mp4
0068_06_0020.mp4
0089_02_0016.mp4
0022_06_0026.mp4
0061_01_0166.mp4
0005_01_0105.mp4
0076_05_0004.mp4
0016_03_0005.mp4
0053_02_0001.mp4
0078_06_0001.mp4
0076_03_0007.mp4
0137_03_0012.mp4
0081_02_0002.mp4
0171_01_0012.mp4
0059_02_0019.mp4
0012_03_0004.mp4
0170_01_0006.mp4
0005_01_0028.mp4
0082_02_0017.mp4
0007_01_0105.mp4
