0078_06_0050.mp4
0013_01_0030.mp4
0022_06_0038.mp4
0025_01_0015.mp4
0120_03_0041.mp4
0138_06_0007.mp4
0041_02_0011.mp4
0082_01_0079.mp4
0014_01_0097.mp4
0037_03_0010.mp4
0093_01_0048.mp4
0044_01_0004.mp4
0084_01_0016.mp4
0016_03_0168.mp4
0004_03_0058.mp4
0114_02_0002.mp4
0010_01_0076.mp4
0060_01_0077.mp4
0030_02_0016.mp4
0047_02_0033.mp4
0039_04_0004.mp4
0078_01_0116.mp4
0026_05_0001.mp4
0018_06_0070.mp4
0105_01_0011.mp4
0120_04_0003.mp4
0026_00_0019.mp4
0094_00_0010.mp4
0039_01_0009.mp4
0004_03_0096.mp4
0016_06_0079.mp4
0162_02_0001.mp4
0078_06_0028.mp4
0160_02_0013.mp4
0078_02_0131.mp4
0015_01_0121.mp4
0091_02_0007.mp4
0004_03_0034.mp4
0166_02_0022.mp4
0048_03_0002.mp4
0080_01_0139.mp4
0074_03_0034.mp4
0010_02_0167.mp4
0030_04_0016.mp4
0047_02_0056.mp4
0066_02_0009.mp4
0021_01_0020.mp4
0006_03_0004.mp4
0012_06_0051.mp4
0112_00_0011.mp4
0047_03_0112.mp4
0175_05_0022.mp4
0078_01_0067.mp4
0109_01_0005.mp4
0082_01_0031.mp4
0047_06_0012.mp4
0071_03_0017.mp4
0129_01_0001.mp4
0070_01_0065.mp4
0162_02_0013.mp4
0187_03_0090.mp4
0015_05_0001.mp4
0123_02_0009.mp4
0015_01_0025.mp4
0007_04_0002.mp4
0061_01_0090.mp4
0057_01_0104.mp4
0032_01_0083.mp4
0089_02_0015.mp4
0018_06_0006.mp4
0021_03_0004.mp4
0128_03_0017.mp4
0136_03_0043.mp4
0151_01_0014.mp4
0104_06_0002.mp4
0020_02_0011.mp4
0109_03_0007.mp4
0109_00_0008.mp4
0082_01_0058.mp4
0008_01_0102.mp4
0064_01_0022.mp4
0064_02_0021.mp4
0147_04_0002.mp4
0044_06_0025.mp4
0079_06_0007.mp4
0186_04_0004.mp4
0193_01_0004.mp4
0020_03_0042.mp4
0075_02_0060.mp4
0078_01_0012.mp4
0022_01_0266.mp4
0004_01_0118.mp4
0096_01_0080.mp4
0103_02_0012.mp4
0041_02_0019.mp4
0070_01_0143.mp4
0006_01_0044.mp4
0131_01_0009.mp4
0064_01_0135.mp4
0022_01_0152.mp4
0083_03_0020.mp4
0030_01_0052.mp4
0172_02_0011.mp4
0111_01_0020.mp4
0064_01_0179.mp4
0063_01_0186.mp4
0153_02_0005.mp4
0059_01_0015.mp4
0010_03_0055.mp4
0030_04_0007.mp4
0019_01_0019.mp4
0014_00_0003.mp4
0005_01_0027.mp4
0041_01_0032.mp4
0057_02_0021.mp4
0052_03_0003.mp4
0112_03_0005.mp4
0133_01_0009.mp4
0093_01_0002.mp4
0017_02_0014.mp4
0103_02_0026.mp4
0120_02_0005.mp4
0086_05_0007.mp4
0104_00_0004.mp4
0050_02_0005.mp4
0082_01_0035.mp4
0019_06_0002.mp4
0075_01_0029.mp4
0094_00_0003.mp4
0074_03_0022.mp4
0147_03_0006.mp4
0119_02_0001.mp4
0091_03_0041.mp4
0071_02_0015.mp4
0110_05_0007.mp4
0054_02_0030.mp4
0052_01_0240.mp4
0011_00_0039.mp4
0160_01_0006.mp4
0032_01_0052.mp4
0009_01_0079.mp4
0161_05_0010.mp4
0074_06_0004.mp4
0086_02_0044.mp4
0137_06_0006.mp4
0059_01_0096.mp4
0065_00_0010.mp4
0075_01_0051.mp4
0003_02_0137.mp4
0101_01_0012.mp4
0039_01_0035.mp4
0096_01_0097.mp4
0128_02_0029.mp4
0095_01_0024.mp4
0022_01_0064.mp4
0052_01_0025.mp4
0030_02_0024.mp4
0163_02_0010.mp4
0028_06_0013.mp4
0007_02_0006.mp4
0006_03_0025.mp4
0076_02_0134.mp4
0069_01_0042.mp4
0021_02_0111.mp4
0163_05_0001.mp4
0054_05_0019.mp4
0078_03_0003.mp4
0110_03_0012.mp4
0185_01_0019.mp4
0078_01_0097.mp4
0192_01_0009.mp4
0185_02_0013.mp4
0161_05_0015.mp4
0143_01_0001.mp4
0033_01_0024.mp4
0094_01_0003.mp4
0139_00_0015.mp4
0147_01_0002.mp4
0162_06_0009.mp4
0110_01_0027.mp4
0013_02_0036.mp4
0014_01_0013.mp4
0140_02_0003.mp4
0071_01_0107.mp4
0010_01_0035.mp4
0011_00_0028.mp4
0059_01_0048.mp4
0063_01_0130.mp4
0132_02_0012.mp4
0076_02_0001.mp4
0047_06_0015.mp4
0052_02_0019.mp4
0047_01_0021.mp4
0004_05_0021.mp4
0067_01_0013.mp4
0080_03_0010.mp4
0030_01_0034.mp4
0007_01_0014.mp4
0094_06_0006.mp4
0041_02_0034.mp4
0016_03_0078.mp4
0171_05_0002.mp4
0052_03_0020.mp4
0041_02_0014.mp4
0082_01_0028.mp4
0064_01_0064.mp4
0191_02_0010.mp4
0032_02_0029.mp4
0048_02_0077.mp4
0078_01_0027.mp4
0028_05_0032.mp4
0121_01_0003.mp4
0093_01_0007.mp4
0052_01_0055.mp4
0016_01_0129.mp4
0150_02_0007.mp4
0071_01_0096.mp4
0088_03_0021.mp4
0051_01_0066.mp4
0076_02_0149.mp4
0022_06_0028.mp4
0062_03_0001.mp4
0007_01_0129.mp4
0008_01_0080.mp4
0062_02_0019.mp4
0064_02_0023.mp4
0071_01_0027.mp4
0011_06_0012.mp4
0006_02_0136.mp4
0052_01_0212.mp4
0182_03_0005.mp4
0078_06_0031.mp4
0016_01_0106.mp4
0017_02_0004.mp4
0039_05_0010.mp4
0036_02_0024.mp4
0017_02_0002.mp4
0005_03_0016.mp4
0037_01_0024.mp4
0186_01_0030.mp4
0026_05_0020.mp4
0028_01_0029.mp4
0165_02_0013.mp4
0027_01_0010.mp4
0119_04_0004.mp4
0028_06_0002.mp4
0051_01_0108.mp4
0061_01_0024.mp4
0007_06_0011.mp4
0095_01_0056.mp4
0061_06_0027.mp4
0086_02_0014.mp4
0044_01_0009.mp4
0040_06_0004.mp4
0030_02_0025.mp4
0075_01_0016.mp4
0113_02_0016.mp4
0009_01_0128.mp4
0186_04_0003.mp4
0041_01_0046.mp4
0007_01_0055.mp4
0184_02_0011.mp4
0111_01_0015.mp4
0013_06_0015.mp4
0193_02_0002.mp4
0004_02_0012.mp4
0118_00_0013.mp4
0015_01_0222.mp4
0042_00_0016.mp4
0057_01_0040.mp4
0149_02_0002.mp4
0061_06_0039.mp4
0078_01_0119.mp4
0089_02_0021.mp4
0187_01_0030.mp4
0186_01_0013.mp4
0003_01_0070.mp4
0147_02_0011.mp4
0006_01_0129.mp4
0012_01_0022.mp4
0044_06_0009.mp4
0079_01_0025.mp4
0051_03_0005.mp4
0052_02_0028.mp4
0030_01_0003.mp4
0179_05_0006.mp4
0008_01_0073.mp4
0016_03_0101.mp4
0020_01_0096.mp4
0154_02_0003.mp4
0119_04_0010.mp4
0017_03_0011.mp4
0051_01_0045.mp4
0175_06_0007.mp4
0068_02_0009.mp4
0052_01_0068.mp4
0106_06_0008.mp4
0031_04_0003.mp4
0015_01_0063.mp4
0015_01_0325.mp4
0191_01_0002.mp4
0133_02_0009.mp4
0006_01_0113.mp4
0012_06_0005.mp4
0035_06_0028.mp4
0085_01_0065.mp4
0057_01_0144.mp4
0013_02_0003.mp4
0061_02_0059.mp4
0139_05_0015.mp4
0004_03_0067.mp4
0124_02_0041.mp4
0168_05_0004.mp4
0085_05_0002.mp4
0123_05_0003.mp4
0054_04_0008.mp4
0022_01_0268.mp4
0096_02_0018.mp4
0110_03_0011.mp4
0051_01_0162.mp4
0094_01_0034.mp4
0069_01_0119.mp4
0013_00_0010.mp4
0027_04_0005.mp4
0137_01_0001.mp4
0013_06_0002.mp4
0022_03_0011.mp4
0006_06_0049.mp4
0142_03_0133.mp4
0193_03_0010.mp4
0133_01_0003.mp4
0004_01_0114.mp4
0020_01_0047.mp4
0004_05_0002.mp4
0080_01_0054.mp4
0110_02_0004.mp4
0006_06_0044.mp4
0154_02_0002.mp4
0013_01_0022.mp4
0016_01_0090.mp4
0135_02_0012.mp4
0172_03_0004.mp4
0061_02_0005.mp4
0187_03_0054.mp4
0164_01_0005.mp4
0075_01_0092.mp4
0041_06_0012.mp4
0078_02_0060.mp4
0008_01_0144.mp4
0027_04_0003.mp4
0051_01_0145.mp4
0154_06_0006.mp4
0027_06_0024.mp4
0084_01_0025.mp4
0045_02_0005.mp4
0032_01_0042.mp4
0084_03_0015.mp4
0013_02_0026.mp4
0032_02_0049.mp4
0137_01_0015.mp4
0036_01_0054.mp4
0103_01_0074.mp4
0006_01_0025.mp4
0003_01_0024.mp4
0068_01_0008.mp4
0009_01_0009.mp4
0089_02_0043.mp4
0135_03_0021.mp4
0025_01_0032.mp4
0006_03_0035.mp4
0064_01_0173.mp4
0016_06_0080.mp4
0015_04_0033.mp4
0017_03_0010.mp4
0003_02_0117.mp4
