0071_01_0011.mp4
0035_04_0005.mp4
0036_02_0015.mp4
0081_05_0026.mp4
0139_02_0046.mp4
0020_06_0012.mp4
0020_06_0040.mp4
0063_01_0137.mp4
0149_01_0002.mp4
0096_06_0007.mp4
0182_06_0006.mp4
0057_01_0135.mp4
0058_02_0013.mp4
0063_01_0057.mp4
0057_01_0082.mp4
0051_01_0058.mp4
0006_01_0024.mp4
0189_06_0003.mp4
0027_02_0041.mp4
0012_02_0011.mp4
0051_01_0146.mp4
0016_03_0223.mp4
0178_02_0016.mp4
0006_02_0116.mp4
0069_01_0004.mp4
0038_02_0036.mp4
0103_01_0015.mp4
0021_01_0003.mp4
0172_03_0007.mp4
0039_00_0003.mp4
0081_02_0075.mp4
0182_02_0003.mp4
0073_01_0024.mp4
0010_01_0030.mp4
0193_05_0007.mp4
0010_02_0035.mp4
0079_03_0001.mp4
0133_00_0013.mp4
0115_02_0027.mp4
0051_01_0032.mp4
0035_05_0003.mp4
0004_03_0015.mp4
0150_03_0006.mp4
0115_02_0002.mp4
0062_01_0029.mp4
0084_06_0008.mp4
0006_02_0179.mp4
0134_03_0009.mp4
0016_01_0110.mp4
0078_03_0018.mp4
0013_01_0049.mp4
0003_01_0052.mp4
0060_01_0015.mp4
0016_01_0123.mp4
0119_03_0003.mp4
0109_02_0026.mp4
0142_03_0113.mp4
0004_01_0025.mp4
0047_03_0004.mp4
0076_01_0005.mp4
0054_03_0068.mp4
0134_06_0001.mp4
0015_01_0186.mp4
0082_06_0040.mp4
0036_01_0026.mp4
0146_01_0004.mp4
0095_03_0007.mp4
0006_01_0010.mp4
0052_01_0067.mp4
0104_02_0010.mp4
0122_02_0003.mp4
0187_03_0035.mp4
0081_01_0009.mp4
0163_01_0022.mp4
0003_01_0042.mp4
0074_03_0038.mp4
0171_01_0009.mp4
0021_02_0121.mp4
0063_01_0005.mp4
0127_01_0013.mp4
0022_01_0082.mp4
0074_03_0005.mp4
0094_03_0005.mp4
0006_01_0004.mp4
0077_05_0016.mp4
0072_01_0085.mp4
0154_02_0013.mp4
0177_00_0004.mp4
0028_04_0003.mp4
0098_03_0003.mp4
0097_03_0015.mp4
0071_01_0035.mp4
0052_01_0166.mp4
0045_01_0022.mp4
0104_02_0026.mp4
0016_06_0033.mp4
0161_01_0006.mp4
0081_03_0001.mp4
0096_01_0004.mp4
0007_01_0053.mp4
0045_02_0025.mp4
0016_03_0069.mp4
0042_00_0014.mp4
0028_00_0006.mp4
0009_01_0116.mp4
0021_01_0039.mp4
0006_06_0050.mp4
0078_01_0038.mp4
0185_03_0011.mp4
0016_00_0111.mp4
0029_02_0004.mp4
0006_06_0071.mp4
0052_05_0002.mp4
0135_01_0001.mp4
0061_01_0086.mp4
0090_01_0005.mp4
0012_05_0001.mp4
0017_01_0114.mp4
0010_02_0112.mp4
0022_03_0003.mp4
0071_01_0002.mp4
0095_01_0027.mp4
0155_01_0003.mp4
0076_00_0004.mp4
0022_01_0066.mp4
0100_06_0002.mp4
0004_01_0151.mp4
0021_02_0046.mp4
0030_02_0088.mp4
0070_01_0128.mp4
0061_01_0100.mp4
0022_01_0105.mp4
0139_00_0002.mp4
0128_00_0010.mp4
0057_00_0008.mp4
0064_01_0062.mp4
0069_01_0097.mp4
0041_05_0002.mp4
0016_06_0013.mp4
0047_01_0010.mp4
0032_02_0059.mp4
0031_03_0003.mp4
0064_04_0002.mp4
0021_02_0062.mp4
0184_02_0002.mp4
0132_03_0002.mp4
0054_02_0056.mp4
0059_03_0016.mp4
0015_01_0189.mp4
0011_06_0016.mp4
0057_01_0018.mp4
0017_01_0022.mp4
0052_01_0268.mp4
0100_01_0046.mp4
0040_02_0013.mp4
0121_03_0014.mp4
0016_03_0071.mp4
0022_01_0263.mp4
0035_04_0023.mp4
0020_04_0003.mp4
0092_01_0013.mp4
0106_03_0025.mp4
0063_01_0018.mp4
0072_02_0015.mp4
0187_03_0071.mp4
0015_05_0004.mp4
0015_01_0096.mp4
0071_01_0053.mp4
0171_01_0006.mp4
0076_02_0065.mp4
0097_02_0017.mp4
0016_03_0059.mp4
0026_03_0005.mp4
0005_02_0022.mp4
0069_05_0012.mp4
0106_06_0013.mp4
0039_02_0027.mp4
0123_06_0005.mp4
0054_02_0019.mp4
0102_02_0023.mp4
0174_01_0005.mp4
0153_00_0003.mp4
0063_01_0080.mp4
0072_03_0009.mp4
0015_01_0307.mp4
0052_01_0292.mp4
0106_01_0010.mp4
0126_01_0015.mp4
0051_01_0018.mp4
0075_02_0083.mp4
0008_01_0169.mp4
0118_03_0004.mp4
0027_01_0007.mp4
0015_01_0079.mp4
0052_01_0154.mp4
0048_02_0022.mp4
0010_02_0134.mp4
0109_02_0002.mp4
0182_01_0010.mp4
0026_01_0050.mp4
0136_04_0003.mp4
0091_01_0042.mp4
0136_04_0008.mp4
0186_02_0017.mp4
0088_03_0002.mp4
0026_01_0064.mp4
0077_06_0001.mp4
0032_01_0019.mp4
0057_00_0012.mp4
0126_00_0008.mp4
0143_01_0015.mp4
0052_01_0158.mp4
0070_06_0019.mp4
0115_02_0021.mp4
0078_02_0099.mp4
0144_02_0020.mp4
0004_02_0005.mp4
0025_02_0028.mp4
0010_02_0098.mp4
0008_01_0111.mp4
0057_02_0024.mp4
0005_03_0014.mp4
0049_02_0021.mp4
0036_01_0010.mp4
0003_02_0119.mp4
0150_01_0017.mp4
0091_02_0025.mp4
0057_01_0146.mp4
0187_01_0018.mp4
0015_01_0183.mp4
0192_01_0003.mp4
0120_05_0014.mp4
0022_01_0098.mp4
0060_02_0003.mp4
0008_01_0112.mp4
0059_03_0010.mp4
0053_01_0011.mp4
0162_01_0004.mp4
0161_00_0007.mp4
0100_05_0002.mp4
0047_04_0004.mp4
0033_05_0003.mp4
0087_03_0049.mp4
0012_06_0064.mp4
0077_03_0002.mp4
0020_01_0090.mp4
0006_02_0185.mp4
0068_00_0021.mp4
0010_01_0089.mp4
0097_03_0012.mp4
0006_02_0015.mp4
0192_00_0006.mp4
0019_06_0035.mp4
0036_03_0011.mp4
0185_02_0006.mp4
0022_01_0099.mp4
0126_02_0020.mp4
0052_01_0082.mp4
0006_03_0040.mp4
0144_01_0015.mp4
0057_06_0004.mp4
0053_02_0019.mp4
0078_06_0033.mp4
0066_02_0001.mp4
0124_03_0021.mp4
0018_06_0068.mp4
0140_03_0009.mp4
0015_04_0044.mp4
0014_01_0064.mp4
0145_01_0021.mp4
0052_01_0223.mp4
0078_01_0101.mp4
0035_00_0023.mp4
0006_01_0067.mp4
0038_06_0013.mp4
0090_01_0015.mp4
0015_02_0003.mp4
0038_00_0013.mp4
0107_06_0003.mp4
0063_01_0081.mp4
0184_06_0002.mp4
0071_01_0088.mp4
0171_01_0002.mp4
0060_02_0005.mp4
0048_00_0005.mp4
0007_01_0029.mp4
0164_01_0007.mp4
0115_02_0012.mp4
0141_06_0003.mp4
0035_05_0012.mp4
0180_02_0022.mp4
0010_02_0036.mp4
0070_01_0015.mp4
0003_01_0071.mp4
0103_02_0040.mp4
0143_01_0003.mp4
0071_01_0003.mp4
0018_01_0005.mp4
0086_03_0012.mp4
0021_01_0052.mp4
0012_02_0002.mp4
0015_01_0114.mp4
0019_01_0039.mp4
0047_06_0009.mp4
0080_01_0092.mp4
0032_06_0024.mp4
0064_01_0147.mp4
0128_03_0018.mp4
0189_06_0009.mp4
0072_01_0015.mp4
0175_02_0002.mp4
0022_01_0125.mp4
0014_02_0024.mp4
0133_00_0018.mp4
0137_02_0017.mp4
0106_00_0021.mp4
0109_03_0011.mp4
0057_01_0102.mp4
0040_02_0024.mp4
0062_06_0015.mp4
0072_01_0060.mp4
0015_01_0018.mp4
0066_03_0011.mp4
0144_01_0006.mp4
0058_01_0064.mp4
0026_01_0031.mp4
0151_02_0015.mp4
0015_01_0299.mp4
0026_01_0025.mp4
0048_02_0015.mp4
0100_01_0001.mp4
0052_05_0016.mp4
0061_02_0065.mp4
0083_01_0008.mp4
0152_02_0003.mp4
0115_02_0019.mp4
0104_06_0015.mp4
0076_04_0008.mp4
0020_01_0009.mp4
0013_01_0047.mp4
0104_01_0002.mp4
0124_02_0011.mp4
0020_02_0002.mp4
0065_01_0036.mp4
0069_05_0013.mp4
0064_01_0047.mp4
0010_01_0104.mp4
0135_06_0002.mp4
0019_06_0076.mp4
0036_02_0050.mp4
0081_02_0078.mp4
0192_02_0009.mp4
0019_03_0033.mp4
0032_02_0018.mp4
0052_01_0076.mp4
0006_04_0009.mp4
0165_01_0010.mp4
0005_03_0022.mp4
0175_02_0017.mp4
0187_03_0004.mp4
0059_01_0109.mp4
0011_00_0047.mp4
0042_01_0002.mp4
0107_01_0007.mp4
0005_02_0006.mp4
0042_06_0011.mp4
0003_02_0095.mp4
0016_03_0187.mp4
0132_01_0005.mp4
0080_01_0029.mp4
0059_05_0006.mp4
0179_00_0006.mp4
0010_02_0065.mp4
0036_01_0047.mp4
0082_01_0087.mp4
