0101_02_0018.mp4
0173_06_0003.mp4
0016_06_0088.mp4
0015_01_0112.mp4
0014_02_0026.mp4
0040_05_0009.mp4
0051_01_0095.mp4
0062_01_0001.mp4
0134_06_0002.mp4
0136_00_0011.mp4
0006_02_0027.mp4
0124_03_0010.mp4
0007_01_0030.mp4
0100_01_0060.mp4
0004_03_0080.mp4
0109_02_0007.mp4
0027_01_0021.mp4
0175_05_0013.mp4
0021_01_0035.mp4
0032_03_0006.mp4
0154_00_0004.mp4
0016_00_0072.mp4
0045_02_0013.mp4
0004_01_0027.mp4
0144_01_0002.mp4
0064_01_0174.mp4
0016_03_0039.mp4
0003_02_0054.mp4
0036_01_0058.mp4
0124_02_0023.mp4
0018_06_0004.mp4
0019_02_0035.mp4
0008_01_0155.mp4
0015_00_0006.mp4
0004_01_0155.mp4
0166_00_0007.mp4
0082_01_0055.mp4
0012_00_0007.mp4
0180_02_0025.mp4
0101_00_0006.mp4
0015_01_0024.mp4
0161_05_0016.mp4
0176_01_0003.mp4
0018_06_0045.mp4
0132_01_0001.mp4
0078_02_0047.mp4
0038_06_0012.mp4
0081_02_0049.mp4
0158_02_0003.mp4
0019_06_0068.mp4
0010_02_0177.mp4
0104_03_0004.mp4
0006_03_0048.mp4
0015_01_0026.mp4
0032_01_0026.mp4
0018_03_0003.mp4
0049_03_0057.mp4
0019_03_0023.mp4
0096_01_0005.mp4
0168_01_0012.mp4
0118_05_0014.mp4
0016_03_0132.mp4
0059_02_0008.mp4
0032_06_0020.mp4
0160_02_0017.mp4
0136_00_0010.mp4
0016_00_0119.mp4
0102_02_0018.mp4
0029_01_0010.mp4
0187_03_0094.mp4
0168_02_0019.mp4
0016_06_0086.mp4
0030_01_0032.mp4
0107_00_0026.mp4
0122_01_0016.mp4
0032_00_0001.mp4
0015_01_0035.mp4
0121_03_0019.mp4
0078_02_0011.mp4
0003_02_0025.mp4
0178_03_0023.mp4
0128_01_0006.mp4
0127_01_0017.mp4
0035_05_0001.mp4
0003_02_0073.mp4
0020_01_0140.mp4
0066_02_0006.mp4
0045_01_0001.mp4
0084_03_0027.mp4
0050_01_0021.mp4
0040_03_0004.mp4
0019_06_0015.mp4
0022_06_0029.mp4
0010_02_0174.mp4
0048_02_0094.mp4
0003_01_0001.mp4
0069_02_0009.mp4
0020_03_0047.mp4
0145_01_0009.mp4
0083_01_0020.mp4
0120_03_0012.mp4
0074_00_0003.mp4
0161_05_0024.mp4
0036_02_0059.mp4
0007_04_0004.mp4
0016_01_0124.mp4
0051_01_0038.mp4
0067_05_0001.mp4
0186_05_0006.mp4
0185_03_0004.mp4
0079_03_0003.mp4
0089_01_0032.mp4
0060_06_0002.mp4
0136_03_0020.mp4
0096_05_0001.mp4
0052_01_0209.mp4
0060_01_0085.mp4
0133_03_0002.mp4
0039_01_0010.mp4
0055_06_0004.mp4
0110_00_0015.mp4
0014_01_0088.mp4
0066_05_0005.mp4
0139_02_0002.mp4
0132_02_0003.mp4
0187_03_0065.mp4
0018_06_0048.mp4
0051_01_0050.mp4
0040_02_0012.mp4
0041_02_0033.mp4
0192_00_0007.mp4
0118_02_0012.mp4
0004_05_0029.mp4
0004_03_0029.mp4
0067_04_0001.mp4
0189_02_0008.mp4
0010_02_0101.mp4
0153_03_0007.mp4
0059_02_0023.mp4
0144_02_0018.mp4
0019_03_0005.mp4
0016_06_0027.mp4
0016_02_0013.mp4
0020_06_0032.mp4
0029_01_0011.mp4
0146_01_0011.mp4
0007_01_0102.mp4
0102_01_0049.mp4
0059_01_0014.mp4
0017_01_0182.mp4
0071_05_0004.mp4
0107_00_0037.mp4
0048_02_0103.mp4
0100_01_0008.mp4
0004_02_0021.mp4
0074_02_0026.mp4
0051_02_0010.mp4
0041_01_0033.mp4
0081_02_0026.mp4
0096_01_0069.mp4
0008_01_0164.mp4
0030_02_0020.mp4
0100_02_0007.mp4
0015_04_0048.mp4
0064_05_0025.mp4
0017_01_0013.mp4
0119_02_0002.mp4
0010_01_0094.mp4
0004_01_0169.mp4
0068_02_0012.mp4
0013_03_0004.mp4
0168_03_0014.mp4
0038_01_0021.mp4
0048_02_0044.mp4
0189_02_0017.mp4
0026_01_0040.mp4
0179_02_0014.mp4
0099_01_0004.mp4
0030_01_0047.mp4
0164_01_0004.mp4
0057_01_0111.mp4
0018_01_0010.mp4
0020_00_0006.mp4
0061_02_0046.mp4
0021_02_0059.mp4
0021_01_0074.mp4
0166_01_0018.mp4
0022_06_0022.mp4
0013_01_0013.mp4
0007_01_0016.mp4
0006_06_0004.mp4
0031_01_0001.mp4
0099_00_0008.mp4
0168_03_0003.mp4
0059_05_0028.mp4
0032_06_0012.mp4
0022_01_0260.mp4
0081_02_0022.mp4
0013_03_0009.mp4
0010_03_0074.mp4
0075_01_0070.mp4
0080_01_0110.mp4
0075_02_0088.mp4
0072_01_0053.mp4
0028_01_0022.mp4
0063_05_0007.mp4
0037_05_0013.mp4
0161_05_0014.mp4
0089_02_0024.mp4
0146_00_0002.mp4
0076_01_0016.mp4
0019_03_0022.mp4
0014_01_0034.mp4
0051_01_0019.mp4
0061_01_0160.mp4
0102_01_0037.mp4
0078_02_0085.mp4
0052_05_0037.mp4
0015_01_0209.mp4
0138_02_0021.mp4
0025_01_0039.mp4
0186_06_0002.mp4
0032_00_0004.mp4
0004_01_0108.mp4
0022_06_0036.mp4
0064_01_0122.mp4
0136_06_0001.mp4
0052_01_0157.mp4
0026_00_0017.mp4
0026_01_0010.mp4
0017_01_0131.mp4
0022_01_0218.mp4
0038_01_0015.mp4
0067_01_0009.mp4
0059_05_0004.mp4
0074_02_0033.mp4
0115_01_0023.mp4
0016_00_0042.mp4
0006_02_0111.mp4
0013_01_0029.mp4
0008_01_0109.mp4
0156_05_0004.mp4
0006_01_0018.mp4
0096_01_0054.mp4
0106_03_0016.mp4
0017_01_0003.mp4
0020_02_0004.mp4
0144_03_0004.mp4
0097_03_0002.mp4
0124_01_0010.mp4
0048_00_0001.mp4
0059_05_0020.mp4
0137_02_0004.mp4
0100_02_0014.mp4
0134_02_0024.mp4
0014_01_0077.mp4
0064_01_0052.mp4
0041_01_0029.mp4
0105_03_0011.mp4
0010_03_0088.mp4
0015_01_0170.mp4
0075_00_0011.mp4
0035_05_0025.mp4
0052_01_0083.mp4
0108_01_0011.mp4
0078_02_0066.mp4
0008_01_0124.mp4
0016_02_0004.mp4
0052_05_0025.mp4
0078_03_0021.mp4
0052_02_0021.mp4
0094_02_0022.mp4
0153_01_0018.mp4
0103_03_0002.mp4
0106_03_0019.mp4
0026_01_0069.mp4
0175_02_0008.mp4
0032_02_0037.mp4
0015_04_0046.mp4
0033_02_0008.mp4
0046_03_0074.mp4
0072_02_0022.mp4
0026_02_0011.mp4
0022_06_0015.mp4
0058_01_0045.mp4
0067_05_0002.mp4
0018_06_0005.mp4
0016_03_0098.mp4
0155_01_0004.mp4
0051_02_0011.mp4
0093_01_0047.mp4
0017_01_0130.mp4
0058_01_0036.mp4
0142_00_0009.mp4
0022_01_0053.mp4
0008_01_0136.mp4
0053_05_0002.mp4
0028_00_0001.mp4
0087_03_0051.mp4
0107_04_0002.mp4
0174_02_0019.mp4
0003_02_0056.mp4
0021_02_0032.mp4
0118_03_0009.mp4
0048_01_0017.mp4
0165_01_0015.mp4
0039_01_0021.mp4
0078_01_0076.mp4
0030_01_0013.mp4
0022_06_0091.mp4
0047_01_0026.mp4
0105_01_0007.mp4
0051_01_0052.mp4
0141_05_0006.mp4
0033_01_0013.mp4
0049_01_0003.mp4
0006_01_0121.mp4
0070_01_0127.mp4
0052_05_0036.mp4
0016_01_0026.mp4
0075_01_0102.mp4
0120_01_0020.mp4
0047_02_0123.mp4
0078_01_0022.mp4
0044_05_0008.mp4
0019_01_0006.mp4
0126_01_0008.mp4
0091_02_0028.mp4
0021_02_0028.mp4
0156_06_0006.mp4
0027_01_0012.mp4
0102_06_0001.mp4
0005_02_0012.mp4
0086_05_0005.mp4
0152_03_0008.mp4
0058_01_0058.mp4
0045_01_0021.mp4
0115_01_0006.mp4
0063_01_0098.mp4
0007_01_0001.mp4
0095_01_0052.mp4
0066_00_0009.mp4
0012_03_0006.mp4
0025_03_0009.mp4
0136_00_0005.mp4
0192_03_0011.mp4
0015_01_0282.mp4
0016_02_0011.mp4
0110_05_0019.mp4
0104_02_0020.mp4
0187_03_0085.mp4
0106_05_0007.mp4
0087_02_0037.mp4
0046_06_0003.mp4
0149_03_0002.mp4
0085_01_0088.mp4
0014_02_0040.mp4
0137_02_0007.mp4
0052_04_0003.mp4
0186_05_0005.mp4
0025_02_0006.mp4
0131_01_0005.mp4
0041_02_0038.mp4
0014_01_0108.mp4
0151_05_0012.mp4
0006_06_0079.mp4
0022_03_0012.mp4
0063_01_0063.mp4
0138_05_0004.mp4
0078_01_0030.mp4
0134_00_0008.mp4
0075_01_0104.mp4
0069_01_0066.mp4
0078_01_0051.mp4
0050_02_0007.mp4
