0006_02_0090.mp4
0072_00_0024.mp4
0072_03_0008.mp4
0019_01_0072.mp4
0162_06_0005.mp4
0090_01_0002.mp4
0069_01_0053.mp4
0112_01_0013.mp4
0029_02_0012.mp4
0116_02_0015.mp4
0115_01_0008.mp4
0054_01_0017.mp4
0178_06_0010.mp4
0144_05_0002.mp4
0187_01_0023.mp4
0057_01_0098.mp4
0078_06_0052.mp4
0044_05_0001.mp4
0022_06_0066.mp4
0149_01_0006.mp4
0007_02_0010.mp4
0010_01_0024.mp4
0015_01_0332.mp4
0082_01_0036.mp4
0047_02_0054.mp4
0010_02_0163.mp4
0099_01_0007.mp4
0057_01_0042.mp4
0059_03_0029.mp4
0117_00_0003.mp4
0046_03_0031.mp4
0047_02_0080.mp4
0124_02_0012.mp4
0030_01_0055.mp4
0030_05_0003.mp4
0079_00_0006.mp4
0015_04_0009.mp4
0010_03_0025.mp4
0094_01_0021.mp4
0020_01_0086.mp4
0151_02_0023.mp4
0025_02_0003.mp4
0087_01_0001.mp4
0007_05_0002.mp4
0003_01_0068.mp4
0003_01_0063.mp4
0103_02_0010.mp4
0016_03_0194.mp4
0087_00_0009.mp4
0003_02_0045.mp4
0086_01_0015.mp4
0074_03_0012.mp4
0120_01_0003.mp4
0020_03_0088.mp4
0048_01_0019.mp4
0117_01_0016.mp4
0052_04_0017.mp4
0193_05_0014.mp4
0069_01_0078.mp4
0169_01_0003.mp4
0069_02_0029.mp4
0070_01_0040.mp4
0082_01_0001.mp4
0190_02_0006.mp4
0047_03_0013.mp4
0051_01_0048.mp4
0014_06_0002.mp4
0136_01_0024.mp4
0094_02_0017.mp4
0052_01_0194.mp4
0052_01_0262.mp4
0006_05_0004.mp4
0184_03_0006.mp4
0040_02_0028.mp4
0044_01_0002.mp4
0142_03_0089.mp4
0151_01_0012.mp4
0020_01_0084.mp4
0054_05_0035.mp4
0169_00_0002.mp4
0072_01_0040.mp4
0030_02_0010.mp4
0032_02_0022.mp4
0164_01_0008.mp4
0070_01_0095.mp4
0018_06_0056.mp4
0019_06_0038.mp4
0022_03_0014.mp4
0006_02_0118.mp4
0052_01_0250.mp4
0103_04_0009.mp4
0061_06_0005.mp4
0097_06_0004.mp4
0032_02_0016.mp4
0178_05_0007.mp4
0101_03_0010.mp4
0113_02_0007.mp4
0088_02_0029.mp4
0102_04_0014.mp4
0041_06_0010.mp4
0009_01_0044.mp4
0052_01_0045.mp4
0110_05_0015.mp4
0020_01_0097.mp4
0076_04_0009.mp4
0006_02_0054.mp4
0151_06_0011.mp4
0031_03_0016.mp4
0066_01_0002.mp4
0004_03_0082.mp4
0020_01_0057.mp4
0032_02_0011.mp4
0007_01_0119.mp4
0174_05_0006.mp4
0144_02_0007.mp4
0119_06_0001.mp4
0107_00_0040.mp4
0031_06_0017.mp4
0143_02_0029.mp4
0120_02_0014.mp4
0051_01_0119.mp4
0042_01_0007.mp4
0168_02_0008.mp4
0066_01_0011.mp4
0153_04_0002.mp4
0022_01_0043.mp4
0025_01_0034.mp4
0188_03_0001.mp4
0124_01_0007.mp4
0179_05_0014.mp4
0083_05_0008.mp4
0038_02_0031.mp4
0100_01_0073.mp4
0169_06_0005.mp4
0075_01_0025.mp4
0136_01_0011.mp4
0006_05_0005.mp4
0112_04_0002.mp4
0076_02_0137.mp4
0120_06_0003.mp4
0067_00_0012.mp4
0009_02_0002.mp4
0124_01_0008.mp4
0027_01_0004.mp4
0083_03_0010.mp4
0078_01_0034.mp4
0075_01_0007.mp4
0036_00_0005.mp4
0112_02_0024.mp4
0040_05_0008.mp4
0064_00_0010.mp4
0133_04_0004.mp4
0107_05_0001.mp4
0022_01_0081.mp4
0030_04_0019.mp4
0050_06_0004.mp4
0006_02_0098.mp4
0096_00_0001.mp4
0004_01_0139.mp4
0142_03_0013.mp4
0030_01_0016.mp4
0013_03_0027.mp4
0004_03_0020.mp4
0182_05_0013.mp4
0124_05_0004.mp4
0106_02_0007.mp4
0016_01_0068.mp4
0031_02_0020.mp4
0048_02_0042.mp4
0145_05_0009.mp4
0187_01_0014.mp4
0074_02_0006.mp4
0104_06_0023.mp4
0045_02_0014.mp4
0030_02_0008.mp4
0151_03_0003.mp4
0153_01_0021.mp4
0128_00_0012.mp4
0010_01_0019.mp4
0072_01_0009.mp4
0162_06_0003.mp4
0061_01_0010.mp4
0008_01_0078.mp4
0174_03_0008.mp4
0006_04_0006.mp4
0008_01_0055.mp4
0026_02_0044.mp4
0016_00_0100.mp4
0137_01_0004.mp4
0118_03_0026.mp4
0080_01_0089.mp4
0121_02_0008.mp4
0014_01_0119.mp4
0022_06_0040.mp4
0063_01_0187.mp4
0006_01_0112.mp4
0038_00_0026.mp4
0015_01_0157.mp4
0057_01_0145.mp4
0011_01_0006.mp4
0178_02_0012.mp4
0075_01_0009.mp4
0015_01_0106.mp4
0109_06_0030.mp4
0019_01_0052.mp4
0007_02_0024.mp4
0192_03_0002.mp4
0052_01_0038.mp4
0010_03_0076.mp4
0186_04_0008.mp4
0178_03_0017.mp4
0065_01_0035.mp4
0032_05_0003.mp4
0005_01_0082.mp4
0080_03_0002.mp4
0075_01_0010.mp4
0093_02_0022.mp4
0018_01_0004.mp4
0163_06_0004.mp4
0005_04_0001.mp4
0090_00_0002.mp4
0117_01_0015.mp4
0142_01_0023.mp4
0004_03_0013.mp4
0064_01_0180.mp4
0011_06_0017.mp4
0166_01_0014.mp4
0013_02_0030.mp4
0014_01_0118.mp4
0040_02_0014.mp4
0018_01_0012.mp4
0019_03_0001.mp4
0134_02_0020.mp4
0110_05_0001.mp4
0073_01_0023.mp4
0119_01_0013.mp4
0022_06_0042.mp4
0081_02_0010.mp4
0112_03_0004.mp4
0003_01_0037.mp4
0140_01_0017.mp4
0018_06_0016.mp4
0061_03_0019.mp4
0135_00_0012.mp4
0031_02_0024.mp4
0029_01_0029.mp4
0044_06_0026.mp4
0165_01_0007.mp4
0103_02_0036.mp4
0151_02_0003.mp4
0167_06_0002.mp4
0136_02_0026.mp4
0067_03_0007.mp4
0040_05_0007.mp4
0153_03_0003.mp4
0062_05_0006.mp4
0003_01_0041.mp4
0071_03_0012.mp4
0166_05_0007.mp4
0104_02_0016.mp4
0103_01_0018.mp4
0025_01_0019.mp4
0006_06_0073.mp4
0010_02_0135.mp4
0109_05_0002.mp4
0086_02_0015.mp4
0182_05_0010.mp4
0040_02_0002.mp4
0003_01_0009.mp4
0021_02_0116.mp4
0022_01_0067.mp4
0153_02_0007.mp4
0139_04_0006.mp4
0038_00_0031.mp4
0178_02_0011.mp4
0076_02_0006.mp4
0046_01_0033.mp4
0010_01_0097.mp4
0171_03_0005.mp4
0128_03_0004.mp4
0004_05_0031.mp4
0151_06_0008.mp4
0004_01_0061.mp4
0163_06_0006.mp4
0083_05_0012.mp4
0161_01_0004.mp4
0057_01_0108.mp4
0039_01_0006.mp4
0178_01_0028.mp4
0022_01_0002.mp4
0020_05_0002.mp4
0009_01_0025.mp4
0075_02_0092.mp4
0102_01_0026.mp4
0075_02_0056.mp4
0006_06_0013.mp4
0071_02_0010.mp4
0016_06_0005.mp4
0022_01_0021.mp4
0007_03_0004.mp4
0015_01_0173.mp4
0054_05_0042.mp4
0089_02_0007.mp4
0078_01_0086.mp4
0176_01_0014.mp4
0016_06_0002.mp4
0086_00_0002.mp4
0016_00_0113.mp4
0007_03_0001.mp4
0191_02_0009.mp4
0031_02_0026.mp4
0041_05_0003.mp4
0010_02_0062.mp4
0004_03_0051.mp4
0068_00_0024.mp4
0123_01_0004.mp4
0015_01_0091.mp4
0067_02_0004.mp4
0101_01_0021.mp4
0161_00_0002.mp4
0005_01_0020.mp4
0029_01_0025.mp4
0007_01_0040.mp4
0010_02_0057.mp4
0013_01_0009.mp4
0028_03_0014.mp4
0028_03_0013.mp4
0087_03_0055.mp4
0058_01_0021.mp4
0022_06_0069.mp4
0015_06_0013.mp4
0124_01_0024.mp4
0010_02_0210.mp4
0054_00_0037.mp4
0052_03_0009.mp4
0057_01_0138.mp4
0123_05_0002.mp4
0064_01_0057.mp4
0171_01_0024.mp4
0061_01_0036.mp4
0070_01_0125.mp4
0011_00_0027.mp4
0170_02_0015.mp4
0008_01_0006.mp4
0022_06_0101.mp4
0143_02_0011.mp4
0127_01_0016.mp4
0027_04_0011.mp4
0010_02_0079.mp4
0097_06_0014.mp4
0170_02_0013.mp4
0010_01_0050.mp4
0052_01_0210.mp4
0081_01_0056.mp4
0072_02_0006.mp4
0097_01_0006.mp4
0004_05_0011.mp4
0015_01_0126.mp4
0071_02_0004.mp4
0051_01_0015.mp4
0067_03_0047.mp4
0049_03_0060.mp4
0093_01_0044.mp4
0113_02_0014.mp4
0066_02_0012.mp4
0069_05_0014.mp4
0078_02_0051.mp4
0006_03_0037.mp4
0135_03_0001.mp4
0061_02_0038.mp4
0021_01_0068.mp4
0193_01_0006.mp4
0133_03_0018.mp4
0015_01_0156.mp4
0016_03_0165.mp4
