0121_01_0009.mp4
0009_01_0045.mp4
0007_03_0002.mp4
0175_01_0004.mp4
0118_00_0012.mp4
0003_01_0051.mp4
0016_03_0061.mp4
0022_01_0138.mp4
0168_03_0020.mp4
0064_01_0086.mp4
0015_04_0001.mp4
0101_01_0028.mp4
0051_02_0005.mp4
0005_01_0072.mp4
0013_00_0003.mp4
0169_05_0011.mp4
0031_06_0004.mp4
0091_01_0032.mp4
0025_03_0040.mp4
0015_01_0259.mp4
0119_00_0001.mp4
0111_01_0012.mp4
0074_02_0045.mp4
0015_01_0224.mp4
0164_03_0007.mp4
0191_05_0007.mp4
0046_03_0010.mp4
0008_03_0003.mp4
0075_01_0015.mp4
0009_01_0098.mp4
0135_02_0004.mp4
0080_01_0109.mp4
0142_03_0018.mp4
0068_00_0006.mp4
0116_03_0016.mp4
0008_01_0189.mp4
0032_02_0033.mp4
0010_02_0189.mp4
0096_01_0021.mp4
0110_04_0003.mp4
0097_03_0018.mp4
0018_06_0012.mp4
0190_05_0002.mp4
0115_02_0028.mp4
0087_01_0017.mp4
0061_06_0036.mp4
0103_01_0034.mp4
0020_03_0004.mp4
0003_02_0075.mp4
0147_02_0017.mp4
0182_02_0007.mp4
0064_02_0008.mp4
0087_03_0074.mp4
0012_01_0015.mp4
0102_04_0015.mp4
0156_03_0009.mp4
0017_01_0032.mp4
0051_01_0165.mp4
0010_01_0074.mp4
0155_03_0006.mp4
0036_06_0017.mp4
0083_02_0010.mp4
0009_01_0130.mp4
0064_01_0118.mp4
0006_01_0026.mp4
0004_01_0106.mp4
0150_02_0003.mp4
0081_02_0029.mp4
0124_02_0006.mp4
0006_01_0022.mp4
0103_01_0062.mp4
0006_01_0031.mp4
0085_01_0012.mp4
0184_06_0006.mp4
0073_01_0002.mp4
0017_01_0083.mp4
0061_00_0007.mp4
0162_05_0005.mp4
0128_03_0001.mp4
0075_02_0029.mp4
0061_01_0182.mp4
0150_04_0007.mp4
0026_02_0028.mp4
0010_01_0069.mp4
0013_03_0029.mp4
0172_02_0015.mp4
0054_02_0057.mp4
0089_06_0010.mp4
0069_02_0025.mp4
0015_04_0055.mp4
0010_02_0100.mp4
0089_02_0050.mp4
0016_01_0063.mp4
0160_03_0002.mp4
0004_01_0092.mp4
0112_01_0016.mp4
0077_01_0015.mp4
0104_06_0004.mp4
0081_02_0007.mp4
0070_06_0026.mp4
0025_05_0009.mp4
0044_04_0002.mp4
0080_01_0074.mp4
0010_02_0142.mp4
0143_01_0009.mp4
0079_05_0001.mp4
0084_01_0014.mp4
0048_02_0106.mp4
0055_00_0004.mp4
0172_06_0001.mp4
0165_02_0009.mp4
0038_06_0017.mp4
0019_06_0084.mp4
0180_02_0019.mp4
0005_05_0005.mp4
0078_01_0118.mp4
0164_06_0011.mp4
0013_02_0035.mp4
0135_01_0013.mp4
0054_02_0041.mp4
0112_01_0002.mp4
0028_02_0027.mp4
0129_01_0013.mp4
0010_02_0061.mp4
0021_01_0042.mp4
0082_01_0070.mp4
0089_02_0052.mp4
0087_06_0007.mp4
0016_06_0065.mp4
0069_02_0015.mp4
0104_01_0016.mp4
0003_01_0072.mp4
0142_03_0134.mp4
0004_01_0070.mp4
0015_01_0073.mp4
0129_02_0007.mp4
0134_02_0023.mp4
0071_01_0102.mp4
0022_01_0013.mp4
0004_01_0016.mp4
0027_02_0013.mp4
0069_01_0100.mp4
0092_06_0007.mp4
0049_03_0102.mp4
0005_01_0037.mp4
0104_01_0033.mp4
0028_02_0020.mp4
0184_01_0011.mp4
0035_03_0016.mp4
0082_06_0034.mp4
0101_00_0004.mp4
0060_01_0047.mp4
0035_06_0021.mp4
0058_01_0066.mp4
0010_02_0069.mp4
0007_02_0022.mp4
0074_03_0025.mp4
0072_01_0027.mp4
0075_01_0024.mp4
0191_03_0005.mp4
0012_06_0031.mp4
0072_01_0038.mp4
0139_05_0008.mp4
0143_01_0006.mp4
0097_06_0018.mp4
0071_06_0004.mp4
0015_04_0028.mp4
0155_02_0010.mp4
0038_02_0006.mp4
0003_01_0081.mp4
0174_00_0005.mp4
0060_01_0066.mp4
0021_01_0073.mp4
0014_01_0086.mp4
0180_05_0001.mp4
0186_01_0025.mp4
0043_02_0004.mp4
0007_01_0038.mp4
0174_03_0007.mp4
0014_02_0006.mp4
0180_01_0003.mp4
0189_02_0013.mp4
0010_03_0046.mp4
0039_01_0026.mp4
0052_01_0289.mp4
0087_03_0070.mp4
0115_06_0001.mp4
0015_01_0233.mp4
0010_02_0194.mp4
0192_00_0001.mp4
0006_01_0119.mp4
0032_01_0029.mp4
0119_05_0024.mp4
0096_06_0010.mp4
0028_01_0031.mp4
0173_00_0005.mp4
0134_01_0012.mp4
0047_00_0021.mp4
0015_01_0151.mp4
0152_03_0009.mp4
0006_06_0003.mp4
0059_01_0054.mp4
0053_04_0002.mp4
0054_01_0001.mp4
0107_02_0023.mp4
0145_02_0008.mp4
0040_05_0012.mp4
0187_03_0026.mp4
0039_02_0051.mp4
0020_01_0034.mp4
0054_01_0023.mp4
0017_01_0141.mp4
0184_06_0003.mp4
0022_01_0151.mp4
0075_01_0082.mp4
0032_05_0002.mp4
0020_05_0004.mp4
0070_01_0123.mp4
0016_01_0047.mp4
0111_01_0017.mp4
0094_02_0036.mp4
0083_02_0004.mp4
0061_02_0074.mp4
0171_02_0006.mp4
0161_02_0010.mp4
0113_02_0006.mp4
0072_01_0011.mp4
0052_01_0142.mp4
0076_02_0150.mp4
0142_03_0019.mp4
0082_01_0066.mp4
0110_05_0008.mp4
0010_02_0039.mp4
0040_05_0015.mp4
0008_01_0097.mp4
0020_01_0031.mp4
0014_02_0019.mp4
0179_00_0002.mp4
0061_04_0003.mp4
0079_02_0012.mp4
0110_02_0011.mp4
0080_01_0051.mp4
0020_02_0007.mp4
0139_02_0010.mp4
0025_04_0013.mp4
0063_01_0031.mp4
0041_02_0028.mp4
0087_01_0041.mp4
0060_01_0124.mp4
0119_05_0002.mp4
0094_02_0024.mp4
0139_05_0009.mp4
0092_03_0011.mp4
0069_01_0035.mp4
0022_06_0017.mp4
0015_01_0062.mp4
0162_00_0001.mp4
0084_02_0007.mp4
0066_01_0021.mp4
0054_00_0023.mp4
0145_02_0012.mp4
0129_03_0002.mp4
0166_06_0007.mp4
0104_06_0020.mp4
0032_02_0027.mp4
0017_01_0127.mp4
0148_02_0011.mp4
0046_02_0009.mp4
0061_02_0100.mp4
0004_02_0010.mp4
0139_02_0033.mp4
0178_02_0015.mp4
0169_01_0012.mp4
0021_02_0110.mp4
0087_03_0042.mp4
0180_02_0009.mp4
0184_01_0003.mp4
0076_04_0015.mp4
0191_02_0011.mp4
0081_01_0044.mp4
0076_02_0089.mp4
0006_02_0052.mp4
0016_03_0142.mp4
0104_01_0009.mp4
0101_01_0024.mp4
0011_02_0005.mp4
0015_01_0031.mp4
0020_01_0119.mp4
0061_02_0015.mp4
0095_01_0013.mp4
0153_05_0001.mp4
0123_01_0005.mp4
0019_01_0047.mp4
0022_01_0050.mp4
0102_04_0011.mp4
0019_01_0042.mp4
0144_02_0011.mp4
0006_02_0165.mp4
0188_03_0024.mp4
0088_05_0004.mp4
0064_01_0017.mp4
0020_01_0116.mp4
0019_02_0042.mp4
0057_02_0022.mp4
0054_04_0005.mp4
0082_01_0010.mp4
0052_01_0171.mp4
0107_02_0044.mp4
0079_01_0010.mp4
0080_01_0004.mp4
0157_05_0001.mp4
0047_03_0009.mp4
0003_02_0030.mp4
0132_01_0009.mp4
0054_01_0012.mp4
0030_02_0021.mp4
0059_01_0103.mp4
0078_01_0123.mp4
0048_02_0041.mp4
0153_02_0003.mp4
0020_03_0031.mp4
0040_02_0007.mp4
0016_00_0087.mp4
0017_01_0018.mp4
0039_01_0049.mp4
0025_00_0001.mp4
0080_01_0144.mp4
0143_01_0020.mp4
0033_02_0007.mp4
0137_00_0002.mp4
0061_01_0038.mp4
0066_02_0008.mp4
0066_06_0009.mp4
0020_03_0074.mp4
0076_02_0084.mp4
0057_02_0010.mp4
0150_02_0021.mp4
0016_01_0054.mp4
0003_02_0057.mp4
0096_01_0027.mp4
0057_01_0060.mp4
0014_01_0016.mp4
0082_01_0038.mp4
0010_02_0120.mp4
0041_02_0005.mp4
0109_01_0013.mp4
0063_05_0002.mp4
0072_01_0092.mp4
0074_03_0033.mp4
0081_05_0027.mp4
0088_01_0009.mp4
0047_03_0052.mp4
0031_05_0002.mp4
0061_02_0017.mp4
0018_06_0003.mp4
0015_02_0007.mp4
0063_01_0136.mp4
0016_01_0086.mp4
0061_01_0127.mp4
0016_01_0014.mp4
0081_01_0040.mp4
0016_00_0017.mp4
0074_03_0027.mp4
0138_02_0023.mp4
0080_03_0008.mp4
0013_01_0024.mp4
0087_03_0020.mp4
0028_05_0014.mp4
0162_00_0008.mp4
0019_03_0029.mp4
0095_01_0050.mp4
0064_01_0102.mp4
0121_05_0004.mp4
0121_01_0002.mp4
0017_01_0115.mp4
