0037_05_0008.mp4
0022_01_0241.mp4
0085_00_0005.mp4
0180_01_0007.mp4
0060_02_0007.mp4
0063_01_0011.mp4
0116_03_0006.mp4
0093_05_0002.mp4
0139_01_0015.mp4
0084_05_0001.mp4
0060_01_0090.mp4
0173_01_0003.mp4
0021_02_0109.mp4
0022_06_0084.mp4
0016_03_0110.mp4
0130_02_0010.mp4
0193_03_0009.mp4
0142_00_0008.mp4
0010_03_0012.mp4
0126_02_0010.mp4
0008_01_0179.mp4
0164_05_0004.mp4
0060_05_0001.mp4
0016_01_0005.mp4
0058_01_0013.mp4
0168_03_0006.mp4
0021_02_0083.mp4
0162_03_0012.mp4
0014_02_0033.mp4
0118_03_0019.mp4
0052_01_0257.mp4
0072_05_0007.mp4
0080_01_0131.mp4
0029_02_0015.mp4
0052_03_0022.mp4
0065_01_0029.mp4
0003_01_0038.mp4
0069_01_0074.mp4
0014_01_0098.mp4
0010_02_0031.mp4
0020_01_0043.mp4
0064_01_0091.mp4
0136_06_0012.mp4
0137_01_0008.mp4
0027_06_0013.mp4
0014_01_0050.mp4
0077_05_0013.mp4
0054_02_0047.mp4
0062_01_0023.mp4
0098_01_0013.mp4
0025_03_0022.mp4
0075_01_0056.mp4
0058_01_0056.mp4
0085_01_0061.mp4
0064_01_0178.mp4
0052_01_0180.mp4
0148_02_0021.mp4
0014_01_0030.mp4
0021_02_0063.mp4
0061_01_0163.mp4
0043_02_0001.mp4
0136_02_0010.mp4
0075_02_0022.mp4
0122_06_0006.mp4
0069_01_0126.mp4
0188_03_0022.mp4
0010_02_0175.mp4
0022_01_0019.mp4
0020_03_0025.mp4
0022_01_0253.mp4
0008_01_0141.mp4
0054_01_0033.mp4
0030_01_0048.mp4
0061_06_0041.mp4
0065_02_0018.mp4
0138_02_0002.mp4
0006_06_0027.mp4
0026_01_0068.mp4
0081_02_0031.mp4
0049_01_0011.mp4
0091_03_0002.mp4
0009_01_0054.mp4
0074_00_0036.mp4
0123_03_0007.mp4
0089_01_0013.mp4
0095_01_0036.mp4
0054_02_0012.mp4
0157_01_0007.mp4
0004_01_0150.mp4
0006_02_0102.mp4
0022_01_0031.mp4
0082_01_0048.mp4
0190_01_0009.mp4
0076_02_0030.mp4
0089_01_0039.mp4
0014_01_0095.mp4
0158_05_0002.mp4
0022_02_0026.mp4
0010_02_0091.mp4
0132_01_0016.mp4
0015_01_0257.mp4
0093_01_0037.mp4
0089_01_0029.mp4
0022_01_0158.mp4
0003_01_0012.mp4
0041_05_0006.mp4
0049_01_0012.mp4
0004_01_0111.mp4
0016_00_0098.mp4
0057_01_0066.mp4
0016_03_0036.mp4
0006_02_0030.mp4
0007_05_0013.mp4
0128_05_0003.mp4
0044_05_0004.mp4
0101_03_0003.mp4
0153_00_0006.mp4
0115_02_0016.mp4
0045_01_0011.mp4
0155_01_0012.mp4
0076_06_0010.mp4
0078_06_0026.mp4
0015_01_0029.mp4
0052_01_0196.mp4
0010_03_0027.mp4
0052_01_0202.mp4
0052_01_0260.mp4
0137_01_0012.mp4
0065_01_0002.mp4
0065_02_0008.mp4
0166_05_0006.mp4
0142_02_0003.mp4
0099_06_0008.mp4
0166_05_0010.mp4
0128_00_0007.mp4
0097_01_0001.mp4
0076_02_0108.mp4
0096_01_0011.mp4
0166_06_0005.mp4
0016_03_0090.mp4
0163_00_0011.mp4
0014_01_0026.mp4
0193_01_0012.mp4
0079_01_0008.mp4
0025_02_0033.mp4
0143_03_0019.mp4
0133_05_0001.mp4
0102_01_0018.mp4
0052_05_0024.mp4
0016_00_0105.mp4
0072_01_0033.mp4
0006_02_0026.mp4
0070_00_0003.mp4
0089_01_0016.mp4
0109_01_0021.mp4
0078_00_0012.mp4
0179_04_0008.mp4
0018_00_0001.mp4
0104_01_0034.mp4
0142_03_0046.mp4
0016_06_0039.mp4
0008_01_0126.mp4
0192_01_0011.mp4
0016_03_0038.mp4
0054_01_0007.mp4
0072_01_0073.mp4
0025_03_0036.mp4
0049_03_0007.mp4
0103_01_0052.mp4
0173_02_0011.mp4
0006_02_0084.mp4
0019_02_0009.mp4
0074_03_0006.mp4
0077_01_0003.mp4
0086_03_0016.mp4
0101_01_0001.mp4
0016_00_0102.mp4
0161_02_0004.mp4
0021_02_0095.mp4
0004_02_0019.mp4
0014_02_0001.mp4
0018_06_0020.mp4
0028_06_0018.mp4
0163_01_0016.mp4
0047_01_0025.mp4
0052_01_0228.mp4
0088_03_0008.mp4
0022_06_0032.mp4
0042_02_0024.mp4
0074_05_0010.mp4
0164_02_0001.mp4
0165_01_0003.mp4
0025_05_0003.mp4
0067_00_0008.mp4
0075_00_0001.mp4
0028_02_0004.mp4
0004_01_0097.mp4
0175_02_0023.mp4
0051_01_0099.mp4
0076_02_0025.mp4
0059_05_0022.mp4
0178_02_0009.mp4
0049_01_0006.mp4
0076_00_0003.mp4
0127_01_0008.mp4
0061_01_0037.mp4
0179_05_0015.mp4
0110_05_0009.mp4
0101_02_0016.mp4
0100_01_0029.mp4
0019_01_0083.mp4
0007_02_0019.mp4
0006_02_0128.mp4
0041_06_0009.mp4
0051_06_0014.mp4
0190_02_0011.mp4
0032_01_0004.mp4
0046_03_0075.mp4
0151_06_0004.mp4
0106_03_0012.mp4
0016_06_0001.mp4
0059_00_0009.mp4
0142_03_0062.mp4
0058_01_0061.mp4
0004_05_0019.mp4
0118_01_0002.mp4
0157_01_0006.mp4
0037_03_0009.mp4
0148_01_0024.mp4
0118_00_0008.mp4
0015_01_0015.mp4
0087_06_0002.mp4
0188_02_0006.mp4
0025_02_0020.mp4
0103_01_0029.mp4
0035_00_0020.mp4
0064_00_0009.mp4
0028_02_0011.mp4
0186_01_0033.mp4
0114_01_0005.mp4
0030_01_0035.mp4
0170_02_0003.mp4
0142_00_0003.mp4
0035_06_0010.mp4
0100_01_0071.mp4
0109_02_0008.mp4
0013_03_0018.mp4
0006_01_0074.mp4
0039_02_0008.mp4
0093_01_0028.mp4
0152_01_0008.mp4
0010_01_0059.mp4
0022_01_0157.mp4
0184_04_0002.mp4
0078_02_0072.mp4
0080_01_0080.mp4
0087_03_0041.mp4
0159_00_0007.mp4
0010_02_0060.mp4
0076_04_0006.mp4
0036_06_0005.mp4
0061_01_0099.mp4
0087_02_0052.mp4
0015_01_0194.mp4
0107_00_0013.mp4
0004_01_0146.mp4
0006_06_0062.mp4
0168_05_0003.mp4
0089_01_0019.mp4
0017_01_0120.mp4
0054_02_0002.mp4
0054_00_0009.mp4
0007_01_0098.mp4
0061_01_0080.mp4
0092_02_0004.mp4
0059_05_0012.mp4
0064_01_0050.mp4
0027_01_0034.mp4
0030_02_0073.mp4
0078_01_0117.mp4
0140_01_0014.mp4
0096_01_0043.mp4
0016_01_0028.mp4
0148_02_0001.mp4
0078_02_0089.mp4
0144_02_0009.mp4
0003_02_0125.mp4
0010_01_0045.mp4
0010_03_0003.mp4
0103_02_0011.mp4
0076_02_0056.mp4
0008_01_0151.mp4
0039_02_0031.mp4
0008_01_0054.mp4
0016_06_0084.mp4
0193_05_0012.mp4
0070_02_0005.mp4
0192_01_0006.mp4
0038_02_0007.mp4
0080_06_0003.mp4
0193_02_0010.mp4
0094_03_0021.mp4
0004_03_0068.mp4
0193_04_0001.mp4
0078_01_0054.mp4
0148_03_0003.mp4
0020_01_0120.mp4
0063_01_0122.mp4
0006_01_0039.mp4
0047_03_0060.mp4
0030_01_0056.mp4
0025_02_0059.mp4
0099_02_0007.mp4
0066_03_0004.mp4
0007_06_0018.mp4
0146_05_0007.mp4
0022_01_0097.mp4
0081_01_0035.mp4
0078_06_0013.mp4
0132_02_0006.mp4
0005_01_0084.mp4
0103_02_0028.mp4
0064_04_0001.mp4
0182_00_0012.mp4
0078_02_0024.mp4
0183_01_0010.mp4
0109_02_0024.mp4
0184_05_0008.mp4
0192_03_0005.mp4
0007_05_0014.mp4
0148_03_0001.mp4
0080_01_0157.mp4
0113_01_0008.mp4
0039_02_0046.mp4
0138_01_0016.mp4
0038_02_0004.mp4
0015_03_0009.mp4
0159_02_0011.mp4
0025_04_0012.mp4
0122_06_0003.mp4
0010_01_0040.mp4
0031_02_0027.mp4
0021_02_0008.mp4
0151_06_0006.mp4
0038_01_0010.mp4
0013_01_0045.mp4
0008_01_0206.mp4
0012_02_0018.mp4
0009_01_0021.mp4
0054_01_0014.mp4
0072_03_0012.mp4
0174_02_0014.mp4
0010_02_0173.mp4
0015_01_0274.mp4
0093_01_0046.mp4
0126_00_0006.mp4
0016_03_0048.mp4
0018_06_0043.mp4
0038_02_0011.mp4
0021_02_0080.mp4
0022_01_0065.mp4
0069_04_0004.mp4
0078_02_0118.mp4
0065_01_0010.mp4
0030_01_0004.mp4
0144_02_0026.mp4
0110_01_0008.mp4
0136_01_0027.mp4
0080_01_0134.mp4
0017_01_0149.mp4
0020_00_0012.mp4
0016_03_0093.mp4
0166_01_0016.mp4
0061_06_0050.mp4
0036_00_0002.mp4
