0175_05_0011.mp4
0009_01_0061.mp4
0075_00_0004.mp4
0009_00_0001.mp4
0039_01_0047.mp4
0017_01_0124.mp4
0174_02_0006.mp4
0017_01_0008.mp4
0017_01_0170.mp4
0193_03_0028.mp4
0031_05_0003.mp4
0009_01_0004.mp4
0051_01_0084.mp4
0030_01_0019.mp4
0035_01_0009.mp4
0105_03_0002.mp4
0108_03_0005.mp4
0078_01_0061.mp4
0047_03_0079.mp4
0169_03_0010.mp4
0006_01_0002.mp4
0006_02_0124.mp4
0168_02_0009.mp4
0058_04_0005.mp4
0063_01_0170.mp4
0030_00_0002.mp4
0052_01_0167.mp4
0004_01_0074.mp4
0061_02_0049.mp4
0135_05_0002.mp4
0078_01_0063.mp4
0124_02_0008.mp4
0047_02_0095.mp4
0138_02_0019.mp4
0178_06_0009.mp4
0035_01_0017.mp4
0094_06_0003.mp4
0104_04_0006.mp4
0172_02_0006.mp4
0066_01_0004.mp4
0016_00_0066.mp4
0035_05_0009.mp4
0118_01_0005.mp4
0014_01_0092.mp4
0025_03_0021.mp4
0038_01_0047.mp4
0017_01_0158.mp4
0146_05_0008.mp4
0160_02_0004.mp4
0010_03_0008.mp4
0067_02_0013.mp4
0069_01_0080.mp4
0060_01_0070.mp4
0063_01_0022.mp4
0178_02_0005.mp4
0022_01_0257.mp4
0028_06_0009.mp4
0184_01_0006.mp4
0063_01_0033.mp4
0016_01_0089.mp4
0027_06_0034.mp4
0074_01_0008.mp4
0060_01_0125.mp4
0010_02_0226.mp4
0077_01_0006.mp4
0041_02_0035.mp4
0185_02_0018.mp4
0136_03_0017.mp4
0151_02_0005.mp4
0016_00_0047.mp4
0061_02_0103.mp4
0137_03_0015.mp4
0006_02_0131.mp4
0120_06_0007.mp4
0149_01_0008.mp4
0170_03_0004.mp4
0123_06_0004.mp4
0074_05_0008.mp4
0029_02_0007.mp4
0164_02_0004.mp4
0059_06_0003.mp4
0096_02_0012.mp4
0104_06_0017.mp4
0073_01_0012.mp4
0179_04_0007.mp4
0066_02_0025.mp4
0143_02_0020.mp4
0071_01_0111.mp4
0095_01_0057.mp4
0075_02_0097.mp4
0078_02_0037.mp4
0040_05_0010.mp4
0104_01_0004.mp4
0007_01_0078.mp4
0186_02_0012.mp4
0143_05_0003.mp4
0092_05_0002.mp4
0166_04_0004.mp4
0092_01_0001.mp4
0077_05_0021.mp4
0014_02_0037.mp4
0188_06_0003.mp4
0015_01_0292.mp4
0090_03_0003.mp4
0019_03_0028.mp4
0137_01_0014.mp4
0044_05_0007.mp4
0085_02_0002.mp4
0095_01_0040.mp4
0097_01_0012.mp4
0095_06_0002.mp4
0059_01_0071.mp4
0047_02_0015.mp4
0070_02_0003.mp4
0022_02_0016.mp4
0057_01_0107.mp4
0128_02_0009.mp4
0085_01_0056.mp4
0022_06_0070.mp4
0078_01_0089.mp4
0010_02_0056.mp4
0036_02_0041.mp4
0110_03_0001.mp4
0168_01_0003.mp4
0068_01_0004.mp4
0016_03_0141.mp4
0191_02_0030.mp4
0178_03_0009.mp4
0178_05_0003.mp4
0120_01_0008.mp4
0159_01_0013.mp4
0016_06_0040.mp4
0015_06_0001.mp4
0057_01_0126.mp4
0005_01_0008.mp4
0184_06_0008.mp4
0042_00_0013.mp4
0070_01_0073.mp4
0066_03_0008.mp4
0071_01_0021.mp4
0192_02_0015.mp4
0083_01_0010.mp4
0142_00_0001.mp4
0182_05_0005.mp4
0016_03_0147.mp4
0124_02_0022.mp4
0156_02_0002.mp4
0159_02_0017.mp4
0063_01_0064.mp4
0177_01_0015.mp4
0025_03_0015.mp4
0030_02_0072.mp4
0037_01_0010.mp4
0049_02_0009.mp4
0028_05_0008.mp4
0112_02_0015.mp4
0073_01_0009.mp4
0101_01_0017.mp4
0003_01_0080.mp4
0064_01_0066.mp4
0030_01_0007.mp4
0009_01_0066.mp4
0080_01_0088.mp4
0174_04_0001.mp4
0078_01_0039.mp4
0006_06_0006.mp4
0012_01_0014.mp4
0120_03_0015.mp4
0027_04_0007.mp4
0016_01_0048.mp4
0005_06_0009.mp4
0096_01_0088.mp4
0106_00_0019.mp4
0139_03_0013.mp4
0153_02_0014.mp4
0034_00_0007.mp4
0025_01_0035.mp4
0063_01_0107.mp4
0006_02_0143.mp4
0064_05_0005.mp4
0089_01_0033.mp4
0004_05_0009.mp4
0079_03_0059.mp4
0045_02_0018.mp4
0020_06_0023.mp4
0008_01_0176.mp4
0115_02_0009.mp4
0136_00_0009.mp4
0016_03_0107.mp4
0191_02_0023.mp4
0150_01_0025.mp4
0087_01_0049.mp4
0061_05_0008.mp4
0015_01_0099.mp4
0014_06_0004.mp4
0176_01_0009.mp4
0049_02_0005.mp4
0027_04_0008.mp4
0061_02_0067.mp4
0016_03_0118.mp4
0080_01_0122.mp4
0146_06_0002.mp4
0104_01_0025.mp4
0116_03_0010.mp4
0071_01_0008.mp4
0097_05_0001.mp4
0030_02_0065.mp4
0175_05_0025.mp4
0046_03_0047.mp4
0043_02_0002.mp4
0090_01_0001.mp4
0027_04_0012.mp4
0006_01_0081.mp4
0133_03_0021.mp4
0077_05_0003.mp4
0015_01_0179.mp4
0013_01_0012.mp4
0069_01_0129.mp4
0175_03_0010.mp4
0102_05_0004.mp4
0103_00_0002.mp4
0041_01_0052.mp4
0101_06_0001.mp4
0099_02_0001.mp4
0130_02_0009.mp4
0003_01_0074.mp4
0033_05_0001.mp4
0044_01_0005.mp4
0017_01_0089.mp4
0077_01_0022.mp4
0126_00_0002.mp4
0004_01_0130.mp4
0093_01_0049.mp4
0112_00_0014.mp4
0031_06_0022.mp4
0160_00_0003.mp4
0105_01_0002.mp4
0020_03_0056.mp4
0140_00_0002.mp4
0097_06_0003.mp4
0070_01_0030.mp4
0007_01_0045.mp4
0004_05_0007.mp4
0178_02_0008.mp4
0054_03_0072.mp4
0061_01_0186.mp4
0182_06_0008.mp4
0179_05_0008.mp4
0025_05_0001.mp4
0028_02_0012.mp4
0119_05_0016.mp4
0078_02_0012.mp4
0110_03_0004.mp4
0175_05_0009.mp4
0030_02_0098.mp4
0069_01_0104.mp4
0015_01_0219.mp4
0026_01_0015.mp4
0064_01_0090.mp4
0020_03_0066.mp4
0162_02_0012.mp4
0022_01_0024.mp4
0172_01_0020.mp4
0152_03_0013.mp4
0142_03_0043.mp4
0061_01_0150.mp4
0145_01_0007.mp4
0085_01_0027.mp4
0022_01_0166.mp4
0161_01_0023.mp4
0031_01_0006.mp4
0178_01_0025.mp4
0005_01_0015.mp4
0014_01_0043.mp4
0022_01_0127.mp4
0025_02_0025.mp4
0120_00_0017.mp4
0022_02_0010.mp4
0028_01_0033.mp4
0059_01_0036.mp4
0010_01_0091.mp4
0015_01_0162.mp4
0015_01_0337.mp4
0047_03_0055.mp4
0016_00_0106.mp4
0136_01_0015.mp4
0076_04_0007.mp4
0164_06_0012.mp4
0065_01_0025.mp4
0061_06_0007.mp4
0088_02_0028.mp4
0059_01_0115.mp4
0030_02_0061.mp4
0025_02_0004.mp4
0189_01_0016.mp4
0035_03_0001.mp4
0003_02_0034.mp4
0014_02_0035.mp4
0041_02_0023.mp4
0004_02_0007.mp4
0021_01_0038.mp4
0182_01_0006.mp4
0035_05_0031.mp4
0004_01_0129.mp4
0185_05_0001.mp4
0010_01_0068.mp4
0069_01_0018.mp4
0074_03_0035.mp4
0016_01_0049.mp4
0070_01_0018.mp4
0069_01_0123.mp4
0025_01_0037.mp4
0061_06_0031.mp4
0128_05_0002.mp4
0004_03_0001.mp4
0054_03_0061.mp4
0143_01_0016.mp4
0020_03_0054.mp4
0082_06_0032.mp4
0037_05_0009.mp4
0064_01_0021.mp4
0167_03_0004.mp4
0009_01_0080.mp4
0180_02_0004.mp4
0076_00_0001.mp4
0028_05_0035.mp4
0051_01_0010.mp4
0057_06_0001.mp4
0182_01_0013.mp4
0193_01_0008.mp4
0192_03_0006.mp4
0087_02_0098.mp4
0109_06_0018.mp4
0025_00_0002.mp4
0027_06_0027.mp4
0012_06_0066.mp4
0178_01_0030.mp4
0095_01_0004.mp4
0141_01_0012.mp4
0154_02_0009.mp4
0060_01_0069.mp4
0004_01_0060.mp4
0102_06_0019.mp4
0031_06_0030.mp4
0085_01_0021.mp4
0075_02_0073.mp4
0047_06_0003.mp4
0015_04_0042.mp4
0012_01_0012.mp4
0102_01_0013.mp4
0067_00_0007.mp4
0072_01_0029.mp4
0080_01_0076.mp4
0127_00_0002.mp4
0058_01_0035.mp4
0077_05_0009.mp4
0054_05_0003.mp4
0130_01_0003.mp4
0007_05_0009.mp4
0109_02_0025.mp4
0078_06_0027.mp4
0147_02_0001.mp4
0009_02_0004.mp4
0170_02_0001.mp4
0082_02_0019.mp4
0159_01_0027.mp4
0047_02_0024.mp4
0030_02_0086.mp4
0076_02_0090.mp4
0010_03_0011.mp4
0022_01_0028.mp4
0064_01_0096.mp4
0013_06_0026.mp4
0014_01_0103.mp4
0141_06_0005.mp4
