0091_01_0020.mp4
0022_06_0047.mp4
0005_01_0096.mp4
0054_03_0078.mp4
0025_03_0018.mp4
0048_02_0099.mp4
0107_06_0008.mp4
0014_02_0052.mp4
0007_01_0120.mp4
0061_02_0036.mp4
0019_02_0039.mp4
0187_01_0021.mp4
0128_02_0022.mp4
0075_01_0076.mp4
0047_02_0073.mp4
0047_03_0026.mp4
0038_01_0017.mp4
0087_03_0021.mp4
0137_03_0007.mp4
0176_01_0005.mp4
0075_02_0025.mp4
0048_01_0020.mp4
0052_01_0156.mp4
0008_01_0057.mp4
0078_02_0101.mp4
0007_01_0082.mp4
0052_01_0069.mp4
0006_01_0008.mp4
0118_05_0001.mp4
0076_01_0001.mp4
0191_02_0003.mp4
0076_00_0024.mp4
0035_06_0030.mp4
0075_02_0008.mp4
0129_03_0005.mp4
0080_01_0006.mp4
0039_01_0061.mp4
0084_01_0020.mp4
0137_01_0013.mp4
0059_05_0013.mp4
0118_04_0001.mp4
0025_01_0017.mp4
0146_05_0004.mp4
0025_02_0027.mp4
0078_06_0017.mp4
0016_00_0107.mp4
0145_02_0020.mp4
0067_03_0043.mp4
0091_01_0014.mp4
0081_06_0002.mp4
0107_06_0001.mp4
0040_02_0009.mp4
0008_01_0003.mp4
0137_02_0009.mp4
0167_02_0003.mp4
0075_01_0074.mp4
0036_02_0034.mp4
0061_02_0095.mp4
0021_02_0094.mp4
0026_02_0039.mp4
0076_02_0087.mp4
0058_02_0004.mp4
0047_02_0051.mp4
0016_01_0012.mp4
0094_01_0007.mp4
0047_02_0014.mp4
0061_05_0002.mp4
0017_01_0101.mp4
0020_03_0045.mp4
0133_02_0014.mp4
0065_02_0003.mp4
0037_01_0008.mp4
0078_02_0028.mp4
0005_03_0008.mp4
0020_03_0050.mp4
0107_01_0010.mp4
0119_00_0020.mp4
0109_01_0008.mp4
0170_02_0004.mp4
0008_01_0077.mp4
0047_02_0008.mp4
0022_01_0271.mp4
0164_01_0006.mp4
0120_05_0008.mp4
0186_05_0003.mp4
0039_02_0045.mp4
0022_01_0184.mp4
0064_06_0006.mp4
0022_01_0083.mp4
0061_01_0156.mp4
0059_01_0113.mp4
0127_01_0018.mp4
0040_04_0005.mp4
0094_01_0032.mp4
0033_01_0004.mp4
0026_01_0059.mp4
0069_01_0085.mp4
0061_01_0136.mp4
0070_01_0169.mp4
0107_02_0021.mp4
0151_01_0004.mp4
0051_01_0057.mp4
0140_01_0010.mp4
0028_06_0026.mp4
0061_02_0045.mp4
0035_05_0029.mp4
0031_02_0037.mp4
0132_00_0006.mp4
0139_02_0014.mp4
0022_01_0285.mp4
0027_05_0001.mp4
0003_01_0079.mp4
0140_01_0009.mp4
0032_01_0058.mp4
0103_01_0054.mp4
0152_02_0002.mp4
0108_01_0004.mp4
0039_02_0039.mp4
0028_06_0028.mp4
0075_01_0055.mp4
0163_06_0002.mp4
0081_06_0001.mp4
0019_06_0066.mp4
0165_02_0010.mp4
0144_00_0006.mp4
0049_03_0021.mp4
0036_01_0051.mp4
0005_05_0004.mp4
0008_01_0015.mp4
0072_04_0001.mp4
0107_06_0002.mp4
0014_06_0007.mp4
0017_01_0142.mp4
0180_01_0002.mp4
0085_01_0028.mp4
0052_01_0222.mp4
0017_01_0034.mp4
0193_03_0011.mp4
0065_01_0013.mp4
0042_02_0019.mp4
0070_01_0152.mp4
0136_02_0028.mp4
0012_06_0059.mp4
0184_02_0018.mp4
0075_01_0087.mp4
0173_01_0012.mp4
0006_01_0015.mp4
0177_01_0003.mp4
0041_06_0011.mp4
0096_01_0057.mp4
0145_01_0016.mp4
0060_02_0010.mp4
0035_06_0014.mp4
0089_02_0027.mp4
0070_01_0042.mp4
0175_02_0005.mp4
0050_01_0022.mp4
0156_03_0001.mp4
0191_01_0011.mp4
0118_02_0024.mp4
0042_01_0044.mp4
0182_05_0018.mp4
0084_01_0050.mp4
0053_05_0012.mp4
0010_01_0064.mp4
0165_01_0008.mp4
0068_02_0005.mp4
0054_03_0075.mp4
0054_02_0031.mp4
0022_01_0041.mp4
0018_06_0022.mp4
0063_01_0082.mp4
0016_03_0197.mp4
0091_01_0005.mp4
0097_02_0031.mp4
0019_02_0034.mp4
0015_04_0020.mp4
0082_06_0014.mp4
0008_01_0079.mp4
0167_02_0014.mp4
0097_03_0011.mp4
0130_00_0004.mp4
0162_02_0006.mp4
0052_01_0217.mp4
0088_01_0010.mp4
0139_04_0005.mp4
0094_02_0014.mp4
0146_03_0002.mp4
0019_05_0003.mp4
0038_05_0009.mp4
0004_01_0066.mp4
0061_01_0028.mp4
0004_01_0185.mp4
0022_01_0112.mp4
0010_03_0015.mp4
0022_01_0124.mp4
0054_05_0014.mp4
0008_01_0106.mp4
0110_01_0004.mp4
0139_02_0051.mp4
0069_05_0010.mp4
0010_03_0069.mp4
0011_00_0043.mp4
0151_02_0012.mp4
0131_01_0006.mp4
0006_03_0031.mp4
0059_01_0066.mp4
0083_03_0004.mp4
0165_00_0006.mp4
0080_01_0102.mp4
0022_03_0005.mp4
0003_01_0056.mp4
0022_01_0242.mp4
0010_02_0132.mp4
0039_01_0060.mp4
0008_01_0152.mp4
0119_00_0010.mp4
0046_01_0007.mp4
0102_01_0021.mp4
0010_01_0080.mp4
0087_01_0051.mp4
0019_01_0009.mp4
0116_02_0012.mp4
0107_02_0042.mp4
0074_02_0043.mp4
0080_01_0156.mp4
0052_01_0276.mp4
0046_02_0002.mp4
0096_01_0051.mp4
0015_01_0185.mp4
0101_01_0015.mp4
0010_03_0048.mp4
0119_06_0012.mp4
0124_02_0029.mp4
0037_05_0005.mp4
0016_01_0098.mp4
0005_01_0050.mp4
0008_01_0183.mp4
0151_01_0002.mp4
0124_02_0019.mp4
0116_04_0006.mp4
0185_01_0001.mp4
0006_02_0152.mp4
0009_01_0030.mp4
0066_06_0012.mp4
0163_01_0006.mp4
0063_01_0099.mp4
0070_01_0145.mp4
0016_03_0202.mp4
0069_01_0067.mp4
0017_01_0064.mp4
0112_00_0021.mp4
0086_04_0001.mp4
0160_03_0008.mp4
0121_03_0005.mp4
0138_01_0021.mp4
0075_02_0043.mp4
0106_00_0016.mp4
0118_04_0004.mp4
0169_03_0015.mp4
0193_05_0002.mp4
0112_01_0003.mp4
0131_01_0002.mp4
0017_01_0178.mp4
0101_01_0023.mp4
0066_06_0010.mp4
0058_02_0001.mp4
0082_00_0001.mp4
0086_01_0014.mp4
0019_06_0026.mp4
0054_02_0040.mp4
0008_01_0105.mp4
0060_01_0092.mp4
0047_02_0109.mp4
0153_03_0006.mp4
0090_02_0002.mp4
0022_01_0207.mp4
0009_03_0002.mp4
0070_01_0035.mp4
0039_06_0008.mp4
0124_03_0012.mp4
0060_01_0006.mp4
0049_02_0008.mp4
0087_01_0037.mp4
0026_05_0003.mp4
0036_02_0052.mp4
0053_06_0003.mp4
0065_05_0004.mp4
0004_02_0031.mp4
0072_02_0012.mp4
0076_02_0016.mp4
0087_03_0080.mp4
0064_02_0019.mp4
0043_01_0004.mp4
0064_01_0165.mp4
0061_03_0015.mp4
0080_01_0120.mp4
0089_03_0045.mp4
0054_02_0055.mp4
0042_02_0018.mp4
0057_01_0072.mp4
0177_01_0010.mp4
0109_06_0028.mp4
0010_02_0198.mp4
0070_01_0017.mp4
0151_06_0014.mp4
0015_01_0012.mp4
0031_02_0046.mp4
0103_01_0051.mp4
0015_06_0004.mp4
0062_01_0022.mp4
0101_01_0029.mp4
0016_03_0044.mp4
0020_03_0044.mp4
0078_01_0120.mp4
0052_01_0225.mp4
0047_02_0046.mp4
0069_04_0001.mp4
0010_02_0140.mp4
0047_03_0101.mp4
0037_01_0006.mp4
0015_01_0196.mp4
0093_01_0050.mp4
0019_01_0065.mp4
0142_03_0086.mp4
0014_01_0107.mp4
0078_06_0056.mp4
0062_00_0004.mp4
0012_01_0032.mp4
0016_06_0096.mp4
0095_02_0027.mp4
0006_01_0035.mp4
0003_05_0001.mp4
0059_02_0016.mp4
0057_01_0061.mp4
0094_01_0029.mp4
0061_01_0111.mp4
0141_02_0017.mp4
0071_01_0077.mp4
0051_01_0076.mp4
0069_02_0026.mp4
0010_02_0093.mp4
0078_02_0115.mp4
0052_01_0086.mp4
0075_02_0047.mp4
0027_01_0014.mp4
0108_06_0004.mp4
0053_02_0013.mp4
0041_03_0008.mp4
0070_01_0164.mp4
0082_01_0072.mp4
0071_05_0007.mp4
0193_03_0012.mp4
0094_02_0029.mp4
0075_02_0074.mp4
0010_02_0099.mp4
0069_05_0006.mp4
0049_03_0065.mp4
0069_01_0105.mp4
0141_01_0015.mp4
0025_03_0010.mp4
0076_02_0138.mp4
0189_02_0018.mp4
0039_01_0036.mp4
0019_06_0041.mp4
0162_00_0002.mp4
0189_02_0006.mp4
0006_02_0091.mp4
0088_01_0014.mp4
0089_04_0008.mp4
0049_01_0014.mp4
0106_04_0002.mp4
0171_01_0026.mp4
0015_04_0025.mp4
0136_04_0009.mp4
