0124_05_0015.mp4
0010_02_0214.mp4
0006_06_0033.mp4
0087_03_0088.mp4
0046_03_0021.mp4
0069_02_0030.mp4
0022_01_0236.mp4
0008_01_0008.mp4
0044_06_0018.mp4
0109_02_0010.mp4
0103_01_0037.mp4
0020_03_0002.mp4
0054_02_0029.mp4
0096_01_0016.mp4
0161_02_0006.mp4
0094_03_0015.mp4
0164_06_0019.mp4
0047_02_0097.mp4
0096_01_0009.mp4
0142_03_0153.mp4
0090_00_0001.mp4
0080_01_0128.mp4
0004_03_0043.mp4
0179_00_0009.mp4
0188_03_0009.mp4
0022_01_0129.mp4
0004_01_0049.mp4
0173_01_0017.mp4
0065_02_0034.mp4
0183_02_0004.mp4
0052_01_0213.mp4
0109_01_0010.mp4
0003_02_0079.mp4
0005_01_0057.mp4
0006_02_0025.mp4
0061_02_0007.mp4
0015_06_0003.mp4
0187_01_0028.mp4
0006_02_0186.mp4
0033_02_0010.mp4
0006_02_0149.mp4
0071_03_0011.mp4
0111_01_0002.mp4
0092_02_0021.mp4
0159_02_0016.mp4
0142_02_0013.mp4
0120_03_0032.mp4
0174_01_0003.mp4
0142_03_0034.mp4
0187_03_0042.mp4
0012_01_0001.mp4
0182_02_0008.mp4
0186_01_0026.mp4
0013_06_0017.mp4
0179_02_0012.mp4
0060_01_0120.mp4
0030_02_0104.mp4
0006_04_0002.mp4
0070_01_0163.mp4
0022_06_0056.mp4
0104_02_0021.mp4
0014_01_0029.mp4
0184_05_0006.mp4
0042_01_0048.mp4
0188_02_0001.mp4
0059_01_0063.mp4
0005_01_0040.mp4
0068_05_0001.mp4
0059_01_0080.mp4
0006_02_0053.mp4
0062_02_0027.mp4
0065_02_0028.mp4
0025_03_0012.mp4
0017_06_0002.mp4
0063_01_0100.mp4
0022_06_0044.mp4
0148_02_0004.mp4
0035_00_0011.mp4
0032_02_0046.mp4
0009_01_0049.mp4
0068_05_0002.mp4
0006_06_0093.mp4
0136_01_0018.mp4
0006_01_0082.mp4
0084_03_0004.mp4
0152_02_0001.mp4
0039_01_0074.mp4
0177_01_0002.mp4
0030_01_0053.mp4
0124_02_0021.mp4
0017_01_0122.mp4
0107_02_0032.mp4
0128_02_0002.mp4
0165_03_0014.mp4
0014_01_0063.mp4
0019_06_0074.mp4
0174_02_0005.mp4
0078_02_0125.mp4
0077_05_0014.mp4
0062_05_0004.mp4
0138_03_0015.mp4
0067_03_0025.mp4
0140_03_0017.mp4
0077_01_0007.mp4
0022_06_0009.mp4
0093_01_0030.mp4
0052_01_0165.mp4
0061_01_0141.mp4
0102_02_0027.mp4
0081_01_0007.mp4
0107_01_0017.mp4
0179_00_0012.mp4
0192_02_0001.mp4
0142_03_0052.mp4
0192_01_0013.mp4
0157_02_0013.mp4
0005_01_0046.mp4
0089_01_0011.mp4
0017_03_0003.mp4
0165_01_0009.mp4
0030_05_0001.mp4
0004_02_0001.mp4
0169_02_0014.mp4
0048_02_0070.mp4
0015_04_0035.mp4
0143_02_0019.mp4
0061_02_0033.mp4
0004_02_0029.mp4
0007_01_0051.mp4
0063_01_0078.mp4
0165_01_0011.mp4
0096_06_0003.mp4
0016_03_0006.mp4
0135_01_0004.mp4
0006_06_0037.mp4
0004_03_0040.mp4
0082_01_0068.mp4
0007_01_0049.mp4
0087_02_0065.mp4
0003_02_0065.mp4
0141_03_0006.mp4
0026_02_0024.mp4
0057_06_0008.mp4
0063_01_0028.mp4
0060_01_0057.mp4
0022_06_0090.mp4
0039_02_0020.mp4
0022_06_0014.mp4
0135_06_0026.mp4
0193_02_0008.mp4
0101_06_0003.mp4
0141_02_0013.mp4
0145_01_0003.mp4
0107_02_0015.mp4
0047_02_0099.mp4
0109_01_0024.mp4
0020_01_0139.mp4
0088_01_0012.mp4
0016_06_0014.mp4
0033_00_0002.mp4
0028_02_0002.mp4
0193_03_0023.mp4
0113_00_0005.mp4
0010_01_0058.mp4
0038_04_0003.mp4
0061_02_0027.mp4
0106_02_0006.mp4
0039_02_0042.mp4
0015_04_0014.mp4
0084_01_0048.mp4
0160_01_0004.mp4
0041_02_0008.mp4
0094_02_0037.mp4
0016_03_0087.mp4
0175_02_0014.mp4
0139_03_0009.mp4
0053_04_0012.mp4
0075_02_0012.mp4
0006_06_0088.mp4
0088_05_0002.mp4
0004_01_0004.mp4
0071_01_0022.mp4
0059_01_0061.mp4
0027_00_0009.mp4
0075_00_0035.mp4
0016_06_0021.mp4
0053_05_0008.mp4
0020_01_0014.mp4
0011_06_0007.mp4
0175_05_0024.mp4
0044_00_0001.mp4
0081_02_0016.mp4
0010_03_0071.mp4
0015_01_0078.mp4
0185_02_0008.mp4
0008_01_0120.mp4
0153_02_0017.mp4
0027_06_0002.mp4
0054_03_0074.mp4
0163_01_0021.mp4
0059_01_0042.mp4
0058_01_0028.mp4
0084_06_0014.mp4
0148_02_0003.mp4
0061_01_0117.mp4
0119_01_0012.mp4
0107_00_0023.mp4
0178_03_0008.mp4
0005_03_0010.mp4
0053_05_0005.mp4
0027_06_0009.mp4
0083_03_0008.mp4
0082_03_0005.mp4
0067_03_0028.mp4
0111_01_0018.mp4
0016_03_0100.mp4
0191_02_0039.mp4
0069_02_0011.mp4
0159_02_0012.mp4
0005_02_0023.mp4
0143_02_0008.mp4
0020_01_0027.mp4
0030_02_0092.mp4
0015_02_0015.mp4
0030_02_0107.mp4
0015_05_0012.mp4
0058_03_0004.mp4
0007_01_0054.mp4
0010_03_0067.mp4
0107_02_0029.mp4
0015_04_0005.mp4
0140_03_0012.mp4
0069_01_0020.mp4
0122_01_0012.mp4
0054_03_0050.mp4
0060_01_0061.mp4
0166_05_0002.mp4
0081_01_0013.mp4
0030_02_0087.mp4
0070_01_0027.mp4
0136_00_0007.mp4
0052_02_0029.mp4
0161_01_0005.mp4
0095_02_0040.mp4
0047_01_0009.mp4
0128_03_0008.mp4
0016_00_0005.mp4
0091_04_0001.mp4
0119_04_0012.mp4
0015_01_0206.mp4
0014_02_0008.mp4
0076_02_0097.mp4
0161_00_0011.mp4
0080_03_0001.mp4
0020_03_0034.mp4
0020_03_0015.mp4
0012_06_0050.mp4
0047_03_0103.mp4
0050_01_0008.mp4
0041_02_0026.mp4
0059_01_0100.mp4
0092_06_0009.mp4
0151_02_0008.mp4
0188_03_0011.mp4
0076_02_0113.mp4
0052_05_0021.mp4
0059_00_0006.mp4
0063_01_0161.mp4
0008_01_0099.mp4
0059_01_0032.mp4
0102_04_0009.mp4
0102_01_0046.mp4
0009_01_0058.mp4
0136_00_0012.mp4
0096_01_0040.mp4
0049_02_0011.mp4
0164_00_0004.mp4
0047_03_0049.mp4
0004_03_0012.mp4
0059_01_0025.mp4
0005_06_0001.mp4
0148_02_0008.mp4
0192_01_0012.mp4
0009_01_0041.mp4
0160_01_0009.mp4
0133_00_0006.mp4
0134_02_0010.mp4
0012_01_0028.mp4
0101_02_0017.mp4
0084_01_0051.mp4
0151_01_0009.mp4
0119_04_0017.mp4
0155_04_0001.mp4
0016_03_0131.mp4
0061_02_0054.mp4
0082_06_0056.mp4
0182_05_0003.mp4
0139_02_0034.mp4
0016_01_0010.mp4
0026_01_0060.mp4
0078_02_0043.mp4
0057_06_0002.mp4
0168_03_0021.mp4
0022_01_0193.mp4
0036_01_0059.mp4
0064_01_0113.mp4
0069_01_0032.mp4
0032_01_0080.mp4
0089_06_0006.mp4
0025_01_0063.mp4
0078_02_0082.mp4
0074_01_0005.mp4
0052_05_0005.mp4
0018_06_0060.mp4
0172_04_0003.mp4
0076_01_0020.mp4
0047_03_0096.mp4
0137_04_0001.mp4
0171_02_0002.mp4
0124_05_0016.mp4
0028_03_0004.mp4
0064_00_0008.mp4
0166_03_0011.mp4
0003_02_0138.mp4
0123_03_0006.mp4
0182_00_0011.mp4
0139_01_0016.mp4
0007_01_0047.mp4
0071_01_0084.mp4
0016_01_0060.mp4
0032_06_0021.mp4
0139_00_0001.mp4
0013_06_0030.mp4
0178_05_0008.mp4
0022_01_0180.mp4
0177_02_0008.mp4
0156_02_0006.mp4
0175_02_0016.mp4
0076_02_0054.mp4
0008_01_0007.mp4
0052_01_0189.mp4
0010_02_0084.mp4
0105_01_0015.mp4
0085_01_0080.mp4
0044_01_0012.mp4
0012_06_0024.mp4
0004_01_0128.mp4
0133_00_0021.mp4
0010_01_0016.mp4
0007_01_0034.mp4
0006_06_0086.mp4
0035_06_0013.mp4
0022_01_0185.mp4
0097_02_0001.mp4
0179_05_0009.mp4
0059_05_0005.mp4
0148_01_0014.mp4
0010_03_0041.mp4
0070_01_0113.mp4
0025_02_0060.mp4
0007_01_0031.mp4
0190_02_0010.mp4
0066_06_0002.mp4
0134_01_0010.mp4
0091_01_0021.mp4
0063_01_0034.mp4
0088_01_0002.mp4
0004_01_0173.mp4
0139_01_0017.mp4
0071_01_0016.mp4
0061_01_0083.mp4
0170_06_0010.mp4
0068_02_0016.mp4
0047_00_0018.mp4
0109_01_0019.mp4
