0184_04_0003.mp4
0120_06_0006.mp4
0058_01_0008.mp4
0075_02_0038.mp4
0008_01_0172.mp4
0022_01_0146.mp4
0070_01_0118.mp4
0013_01_0052.mp4
0163_06_0013.mp4
0068_01_0016.mp4
0015_01_0006.mp4
0051_02_0004.mp4
0021_02_0079.mp4
0057_01_0091.mp4
0122_00_0005.mp4
0031_00_0011.mp4
0081_01_0016.mp4
0003_01_0026.mp4
0088_03_0019.mp4
0084_01_0041.mp4
0157_02_0004.mp4
0016_06_0061.mp4
0139_02_0008.mp4
0157_02_0014.mp4
0015_01_0215.mp4
0008_01_0004.mp4
0008_01_0086.mp4
0064_01_0067.mp4
0097_05_0007.mp4
0017_01_0151.mp4
0063_01_0090.mp4
0052_01_0253.mp4
0061_01_0094.mp4
0050_06_0014.mp4
0102_01_0035.mp4
0119_04_0002.mp4
0081_02_0013.mp4
0036_01_0009.mp4
0075_02_0086.mp4
0010_02_0019.mp4
0151_03_0010.mp4
0089_01_0009.mp4
0015_00_0011.mp4
0003_01_0085.mp4
0061_02_0076.mp4
0099_06_0007.mp4
0172_03_0013.mp4
0168_02_0016.mp4
0172_02_0018.mp4
0076_02_0095.mp4
0015_00_0008.mp4
0011_06_0009.mp4
0151_01_0017.mp4
0071_01_0001.mp4
0078_02_0054.mp4
0051_01_0001.mp4
0019_03_0013.mp4
0108_06_0003.mp4
0075_01_0026.mp4
0107_00_0021.mp4
0150_03_0005.mp4
0020_01_0013.mp4
0047_00_0005.mp4
0017_05_0001.mp4
0017_01_0044.mp4
0175_01_0024.mp4
0010_01_0011.mp4
0078_01_0107.mp4
0018_06_0034.mp4
0015_01_0070.mp4
0050_01_0013.mp4
0053_01_0019.mp4
0054_01_0021.mp4
0061_01_0126.mp4
0022_01_0254.mp4
0052_01_0182.mp4
0065_01_0024.mp4
0010_01_0012.mp4
0032_01_0041.mp4
0032_01_0030.mp4
0019_01_0068.mp4
0022_01_0164.mp4
0081_01_0025.mp4
0065_01_0019.mp4
0032_02_0051.mp4
0041_02_0002.mp4
0123_03_0002.mp4
0083_03_0001.mp4
0014_01_0028.mp4
0064_04_0005.mp4
0048_06_0002.mp4
0164_03_0014.mp4
0006_02_0177.mp4
0054_05_0026.mp4
0120_03_0060.mp4
0015_01_0313.mp4
0164_03_0012.mp4
0036_01_0032.mp4
0084_01_0043.mp4
0007_01_0085.mp4
0069_02_0021.mp4
0050_03_0001.mp4
0108_03_0002.mp4
0016_01_0108.mp4
0160_06_0005.mp4
0088_05_0006.mp4
0022_01_0247.mp4
0052_06_0010.mp4
0164_03_0006.mp4
0051_03_0008.mp4
0006_03_0002.mp4
0054_01_0009.mp4
0174_01_0009.mp4
0006_02_0137.mp4
0120_05_0009.mp4
0022_01_0214.mp4
0100_01_0028.mp4
0144_06_0008.mp4
0171_05_0004.mp4
0163_01_0029.mp4
0110_05_0005.mp4
0102_01_0042.mp4
0122_02_0013.mp4
0072_02_0003.mp4
0029_01_0023.mp4
0161_02_0018.mp4
0175_01_0017.mp4
0004_01_0095.mp4
0067_05_0005.mp4
0166_01_0005.mp4
0087_02_0024.mp4
0059_04_0002.mp4
0027_02_0042.mp4
0019_01_0106.mp4
0053_00_0003.mp4
0161_01_0026.mp4
0022_01_0197.mp4
0022_06_0080.mp4
0185_03_0006.mp4
0114_00_0004.mp4
0080_01_0067.mp4
0072_01_0089.mp4
0019_01_0027.mp4
0078_06_0024.mp4
0074_02_0025.mp4
0107_02_0020.mp4
0019_02_0044.mp4
0139_02_0013.mp4
0026_02_0019.mp4
0016_03_0051.mp4
0165_02_0006.mp4
0172_01_0007.mp4
0016_03_0080.mp4
0059_02_0022.mp4
0132_01_0020.mp4
0142_03_0063.mp4
0173_01_0011.mp4
0022_06_0049.mp4
0112_00_0018.mp4
0143_03_0010.mp4
0163_01_0024.mp4
0016_02_0003.mp4
0075_01_0019.mp4
0169_02_0015.mp4
0059_02_0029.mp4
0100_01_0052.mp4
0048_03_0014.mp4
0016_01_0138.mp4
0088_06_0001.mp4
0178_02_0022.mp4
0061_02_0020.mp4
0069_01_0112.mp4
0027_02_0037.mp4
0015_01_0293.mp4
0010_01_0095.mp4
0052_01_0106.mp4
0031_06_0036.mp4
0035_04_0002.mp4
0003_02_0068.mp4
0074_02_0035.mp4
0081_02_0009.mp4
0087_01_0010.mp4
0144_01_0007.mp4
0006_02_0083.mp4
0075_02_0016.mp4
0081_05_0021.mp4
0027_02_0010.mp4
0026_05_0008.mp4
0144_05_0007.mp4
0039_02_0050.mp4
0089_03_0044.mp4
0080_01_0159.mp4
0061_06_0038.mp4
0021_02_0118.mp4
0151_05_0003.mp4
0043_03_0005.mp4
0022_01_0111.mp4
0110_02_0010.mp4
0109_06_0011.mp4
0005_03_0023.mp4
0016_02_0028.mp4
0007_04_0003.mp4
0057_01_0043.mp4
0010_02_0148.mp4
0060_01_0119.mp4
0087_03_0023.mp4
0162_02_0004.mp4
0015_01_0159.mp4
0094_03_0027.mp4
0064_02_0025.mp4
0134_02_0012.mp4
0032_01_0038.mp4
0161_01_0003.mp4
0064_01_0046.mp4
0059_01_0106.mp4
0064_02_0027.mp4
0019_02_0055.mp4
0016_03_0029.mp4
0013_06_0027.mp4
0150_00_0002.mp4
0054_03_0027.mp4
0015_04_0022.mp4
0096_06_0011.mp4
0006_01_0043.mp4
0064_01_0120.mp4
0020_03_0011.mp4
0164_01_0017.mp4
0119_05_0006.mp4
0075_00_0006.mp4
0070_02_0008.mp4
0085_02_0006.mp4
0120_01_0002.mp4
0107_02_0005.mp4
0140_03_0015.mp4
0048_00_0011.mp4
0118_05_0003.mp4
0004_01_0133.mp4
0015_05_0007.mp4
0081_02_0036.mp4
0061_06_0059.mp4
0175_06_0006.mp4
0007_02_0026.mp4
0159_01_0006.mp4
0066_02_0018.mp4
0133_01_0011.mp4
0016_00_0097.mp4
0013_05_0007.mp4
0124_01_0001.mp4
0006_06_0043.mp4
0078_06_0025.mp4
0106_00_0015.mp4
0147_01_0013.mp4
0095_05_0001.mp4
0087_00_0003.mp4
0011_00_0033.mp4
0071_01_0048.mp4
0188_01_0006.mp4
0020_06_0016.mp4
0047_02_0036.mp4
0042_02_0016.mp4
0134_06_0003.mp4
0019_01_0067.mp4
0118_03_0002.mp4
0078_01_0025.mp4
0188_03_0012.mp4
0054_00_0016.mp4
0083_01_0011.mp4
0032_02_0039.mp4
0089_03_0010.mp4
0006_01_0116.mp4
0026_00_0006.mp4
0030_02_0060.mp4
0016_01_0133.mp4
0069_01_0093.mp4
0075_01_0031.mp4
0052_01_0159.mp4
0071_01_0026.mp4
0061_02_0019.mp4
0042_06_0009.mp4
0100_06_0001.mp4
0054_00_0021.mp4
0133_03_0011.mp4
0138_03_0012.mp4
0025_02_0039.mp4
0184_02_0001.mp4
0095_03_0010.mp4
0030_02_0090.mp4
0120_01_0010.mp4
0057_01_0055.mp4
0018_06_0047.mp4
0138_01_0005.mp4
0063_01_0003.mp4
0084_01_0003.mp4
0061_05_0015.mp4
0192_06_0007.mp4
0062_01_0006.mp4
0075_02_0018.mp4
0004_01_0009.mp4
0057_02_0029.mp4
0018_06_0030.mp4
0016_00_0006.mp4
0088_06_0010.mp4
0029_02_0009.mp4
0102_02_0029.mp4
0191_00_0005.mp4
0047_02_0012.mp4
0068_02_0011.mp4
0115_01_0021.mp4
0134_01_0005.mp4
0129_04_0001.mp4
0079_03_0058.mp4
0052_01_0022.mp4
0082_01_0063.mp4
0022_01_0211.mp4
0010_02_0017.mp4
0118_03_0025.mp4
0101_03_0002.mp4
0169_05_0008.mp4
0057_01_0073.mp4
0051_01_0012.mp4
0019_01_0057.mp4
0022_01_0289.mp4
0072_00_0013.mp4
0022_01_0291.mp4
0111_02_0002.mp4
0042_06_0015.mp4
0013_04_0001.mp4
0074_01_0020.mp4
0150_01_0001.mp4
0161_05_0021.mp4
0004_02_0004.mp4
0178_03_0022.mp4
0061_01_0154.mp4
0168_03_0012.mp4
0066_01_0017.mp4
0014_01_0116.mp4
0136_01_0010.mp4
0015_02_0006.mp4
0078_00_0005.mp4
0108_00_0006.mp4
0086_06_0023.mp4
0081_02_0051.mp4
0027_03_0003.mp4
0014_01_0036.mp4
0182_06_0010.mp4
0193_00_0002.mp4
0051_01_0035.mp4
0068_01_0002.mp4
0085_01_0060.mp4
0180_01_0009.mp4
0003_02_0100.mp4
0014_02_0044.mp4
0015_06_0010.mp4
0068_02_0004.mp4
0159_02_0015.mp4
0074_03_0018.mp4
0142_01_0010.mp4
0071_03_0029.mp4
0134_05_0005.mp4
0050_03_0004.mp4
0013_01_0038.mp4
0132_00_0005.mp4
0045_02_0001.mp4
0054_03_0026.mp4
0013_06_0024.mp4
0192_01_0007.mp4
0027_01_0024.mp4
0148_06_0001.mp4
0071_01_0006.mp4
0066_05_0001.mp4
0039_01_0005.mp4
0100_03_0001.mp4
0143_01_0013.mp4
0051_01_0156.mp4
0006_02_0100.mp4
